Desde mi punto de vista, es fundamental proteger el medio ambiente.	From my point of view, it is essential to protect the environment.
En mi opinión, la educación debería ser accesible para todos.	In my opinion, education should be accessible to everyone.
Estoy de acuerdo con la idea de que la tecnología ha mejorado nuestra vida.	I agree with the idea that technology has improved our lives.
No estoy totalmente de acuerdo porque hay otros factores importantes.	I don’t totally agree because there are other important factors.
Por un lado, trabajar desde casa ofrece comodidad; por otro, puede generar aislamiento.	On one hand, working from home offers comfort; on the other, it can cause isolation.
A pesar de los riesgos, pienso que viajar solo puede ser positivo.	Despite the risks, I think traveling alone can be positive.
Lo que me preocupa es la falta de empatía en nuestra sociedad.	What worries me is the lack of empathy in our society.
Es evidente que la globalización tiene ventajas y desventajas.	It is evident that globalization has advantages and disadvantages.
Espero que tengas un buen día. Espero que todo salga bien.	I hope you have a good day. I hope that everything goes well.
Dudo que el gobierno haga lo suficiente para proteger el medio ambiente.	I doubt that the government is doing enough to protect the environment.
Es importante que los jóvenes participen más en la política.	It is important that young people participate more in politics.
No creo que todos tengan las mismas oportunidades.	I don’t think everyone has the same opportunities.
He visitado España dos veces y me encantó la cultura.	I’ve visited Spain twice and I loved the culture.
Cuando era niño, jugaba en el parque todos los días.	When I was a child, I used to play in the park every day.
El año pasado trabajé en una empresa internacional.	Last year I worked in an international company.
Si tuviera más tiempo, viajaría más.	If I had more time, I would travel more.
Me gustaría trabajar en otro país algún día.	I would like to work in another country someday.
Sería mejor que invirtiéramos más en energías renovables.	It would be better if we invested more in renewable energies.
Mañana viajaré a Barcelona para asistir a una conferencia.	Tomorrow I’ll travel to Barcelona to attend a conference.
Te llamaré después para confirmar los detalles.	I’ll call you later to confirm the details.
Creo que el futuro será más digital y sostenible.	I believe the future will be more digital and sustainable.
En resumen, necesitamos actuar juntos para mejorar la situación.	In summary, we need to act together to improve the situation.
En conclusión, todo depende de la educación y la conciencia social.	In conclusion, everything depends on education and social awareness.
Quisiera hacer una reserva para el próximo fin de semana.	I’d like to make a reservation for next weekend.
Disculpe, pero creo que ha habido un error con mi pedido.	Excuse me, but I think there has been a mistake with my order.
lograr	to achieve
creer	to believe
pensar	to think
decir	to say
gustar	to like
molestar	to bother
preocupar	to worry
necesitar	to need
esperar	to hope
dudar	to doubt
recomendar	to recommend
proponer	to propose
deber que, tener que	must, have to
convertirse en	to become
hacer	to do,make
decidir	to decide
intentar	to try
sentir	to feel
haber,hay	there is,are
tener	to have
ir,venir	to go,to come
ir a	to be going to
dar	to give
tomar	to take
parecer	to seem
mejorar,empeorar	improve, worsen
explicar	to explain
conseguir,obtener	to obtain
importante	important
necesario	necessary
valioso	valuable
útil	useful
capaz	capable
posible	possible
difícil,fácil	difficult, easy
claro, evidente	clear, obvious
preocupante	worrying
interesante	interesting
injusto,justo	unfair,fair
sostenible	sustainable
económico	economic
mejor,peor	better,worse
necesario, fundamental	necessary, fundamental
relevante	relevant
beneficioso	beneficial
negativo, positivo	negative, positive
ambiental	environmental
además	moreover
sin embargo	however
aunque	although
porque	because
ya que, dado que	since, given that
por eso	that’s why
por lo tanto	therefore
si	if
en caso de que subjuntivo	in case
primero, después, finalmente	first, then, finally
es decir	that is
por ejemplo	for example
de hecho	in fact
a pesar de	despite
en resumen, en conclusión	in summary, in conclusion
mientras que	whereas
para que subjuntivo	so that
al contrario	on the contrary
más o menos	more or less
desde mi punto de vista	from my point of view
en mi opinión	in my opinion
tal vez, quizás	maybe
en general	in general
problema	problem
solución	solution
ventaja	advantage
desventaja	disadvantage
cambio	change
desarrollo	development
tecnología	technology
medio ambiente	environment
sociedad	society
gobierno	government
empresa	company
trabajo	work
oportunidad	opportunity
experiencia	experience
diferencia	difference
consecuencia	consequence
causa	cause
futuro	future
objetivo	goal, objective


opinar	to express an opinion

pero	but


social	social
global	global
digital	digital

educación	education
