adecuado	adequate, suitable
amplio	wide, ample, broad
cercano	near
concreto	concrete, real
conocido	known, well-known
corriente	current, flow 
corto	short, brief
cuarto	room, chamber 
dado	given
debido debido a 		due to
definitivo	definitive, conclusive
determinado	determined, fixed
diario	newspaper 
dispuesto	willing, ready
diverso	different, several, diverse
duro	hard 
enfermo	ill, sick
entero	entire, whole, complete
exacto	exact, faithful, true
extraño	strange, foreign
extraordinario	extraordinary, exceptional
familiar	familiar, of the family 
grave	serious, solemn
inmediato	immediate
interno	internal
justo	just 
lleno	full, filled 
mas	but, however
parecido	similar [also similar]
plano	plane, map, level 
pleno	complete, fulfilled 
preciso	precise, necessary
presente	present 
raro	strange, rare, scarce
sencillo	simple, plain, easy
serio	serious
supuesto ; por supuesto		supposed: of course		
unido	united
abajo	down, below, downward
adelante	forward, further
alrededor	about, around, round 
apenas	hardly, barely
arriba	up above
aun	even, still
completamente	completely
debajo	underneath, below
delante	in front of, ahead
detrás	in the back
inmediatamente	immediately
jamás	never
recién	recently, just
salvo	except for, but
seguramente	surely, securely
siquiera	even if
totalmente	totally, completely
modelo	model, pattern
actitud	attitude
altura	height, altitude
autoridad	authority
boca	mouth, entrance, opening
calidad	quality
capacidad	capacity
carta	letter, playing card
ciencia	science, knowledge
compañía	company
comunicación	communication
conciencia	conscience, consciousness
confianza	confidence, trust
costumbre	habit, custom, usage
defensa	defense, plea
dificultad	difficulty, obstacle
dirección	direction, address
distancia	distance
elección	election, choice
empresa	firm, company, venture
energía	energy, power
enfermedad	illness, sickness
esperanza	hope
etapa	stage, period
existencia	existence, life
fecha	date, day
formación	formation, education
frase	phrase
fuente	source, fountain
hoja	sheet, leaf
lucha	fight, struggle, wrestle
madera	wood
máquina	machine
marcha	march, progress
masa	mass, dough, bulk, crowd
materia	matter, subject
mayoría	majority
mente	mind
mitad	half, middle
naturaleza	nature
noticia	news
oportunidad	opportunity, chance
pared	interior wall
pareja	couple, pair
paz	peace
pena	trouble 
piedra	stone, rock
piel	skin, hide, fur
pieza	piece, part
planta	plant, floor
población	population
política	politics, policy
posición	position
práctica	practice, skill
preocupación	worry, concern
presencia	presence, appearance
presión	pressure
propiedad	property
prueba	proof, trial, test
reunión	meeting, reunion
revista	magazine, journal
sala	room, hall
salida	exit, escape, outcome
salud	health
sangre	blood
santa	saint 
seguridad	security, safety
serie	series
solución	solution, answer
suerte	luck, fortune
tarea	task, job
teoría	theory
tradición	tradition
vía	road, way
visión	vision
visita	visit, visitor, guest
voluntad	will, willpower, intention
vuelta	return, turn
alma	soul
arma	weapon
acto	act, action
alumno	student, pupil
ambiente	environment, atmosphere
andar	to walk
apoyo	support, backing
artículo	article, product, item
asunto	matter, issue, affair
banco	financial bank, bench
bien	goods, property, benefit 
brazo	arm
caballo	horse
calor	heat, warmth
carácter	personality, nature
cargo	position, charge, fee
cielo	sky, heaven, ceiling
compañero	companion, classmate
conjunto	group, set
corazón	heart, core
cuadro	painting, picture
cuarto	fourth 
cuidado	care, carefulness
dato	data, fact
derecho	right, straight 
desarrollo	development
deseo	desire, wish
destino	destination, destiny
detalle	detail
diario, cotidiano	daily
dolor	pain, ache, sorrow
encuentro	meeting, game, skirmish
equipo	team, equipment, outfit
espíritu	spirit, ghost
estilo	style
éxito	success
fenómeno	phenomenon
golpe	hit, strike, punch
grado	degree, grade
gusto	pleasure, taste, preference
hogar	home, hearth
juicio	judgment
lenguaje	language, speech
límite	limit
metro	meter , subway
miembro	member, limb
motivo	motive, cause, motif
norte	north
origen	origin, cause
oro	gold
peligro	danger, menace
pensamiento	thought, thinking
personaje	character
piso	floor, story
precio	price, cost, value
presidente	president
propósito	intention, purpose
proyecto	project, plan
puesto	job, place, position
recuerdo	memory, keepsake
recurso	resource, recourse, means
respeto	respect, regard
ritmo	rhythm
sueño	dream, sleep
tamaño	size, dimension
término	term , end
terreno	ground, earth, terrain
tono	tone
par	pair, couple 
mediante	by means of
tras	after, behind
aquello	that over there 
abandonar	to abandon, leave a place
acompañar	to accompany
acordar,recordar		to remember, remind	
actuar	to act
admitir	to admit
adquirir	to acquire, get
advertir	to warn
afectar	to affect
afirmar	to assert, affirm
anunciar	to announce, advertise
apoyar	to support, lean on
aprovechar	to take advantage of
asegurar	to assure, secure, insure
asistir	to attend
atender	to serve, attend to
atravesar, cruzar	to cross
aumentar, incrementar	to increase
bajar	to come down, let down
bastar	to be sufficient
caber	to fit into
cargar	to load up, carry
coincidir	to coincide, agree
colocar	to place, position
comentar	to comment on
compartir	to share
comprobar	to verify, prove
conducir	to lead, drive
conservar	to conserve, preserve
consistir	to consist of
constituir	to constitute, consist of
construir	to construct, build
contemplar	to contemplate
contener	to contain
contestar	to answer, reply
convenir	to be agreeable, be convenient
corresponder	to correspond with
costar	to cost, to be hard to do
crecer	to grow, increase
cruzar, atravesar	to cross 
cubrir	to cover
cuidar	to take care of
definir	to define
demostrar	to show, demonstrate
depender	to depend on
desaparecer	to disappear, vanish
desear	to want, desire, wish for
despertar	to wake up, arouse
destacar	to emphasize, stand out
discutir	to argue, discuss
disponer	to have means, dispose
dominar	to dominate, master
durar	to last
emplear	to employ
enfrentar	to confront, face
enseñar	to teach, show
entregar	to deliver
enviar	to send
escapar	to escape
establecer	to establish
exigir	to demand
exponer	to expound, expose
expresar	to express
extender	to extend, spread
faltar	to be lacking
firmar	to sign
funcionar	to work, function
guardar	to keep, save
identificar	to identify
impedir	to prevent, hinder
imponer	to impose, enforce
instalar	to install
interpretar	to interpret
intervenir	to intervene
invitar	to invite
lanzar,arrojar	to throw violently, to hurl
llenar	to fill
mandar	to send, order
manejar	to drive, handle
marcar	to mark, note, dial
matar	to kill
medir	to measure
mejorar	to improve, get better
mencionar	to mention, cite
merecer	to deserve, be worthy of
meter	to put into
montar	to ride, mount, assemble
negar	to deny, refuse
notar, percibir	to notice
obligar	to obligate, force
permanecer	to stay, remain
pertenecer	to belong
pesar	to weigh 
plantear	to propose, present
preocupar	to worry
prestar	to lend
pretender	to attempt
provocar	to cause, provoke
publicar	to publish
quitar	to remove, take away
recoger	to pick up
recorrer	to travel, cover distance
recuperar	to recuperate, recover
regresar	to return to a place
representar	to represent
respetar	to respect
retirar	to take away, retire
reunir, juntar	to put together, to get together
romper	to break
salvar	to save, rescue
sentar	to sit down, seat
significar	to mean
sostener	to support, hold up
superar	to overcome, surpass
surgir	to appear, spring forth
tardar	to delay, take long
tender	to tend to, lay out
tirar	to throw, pull
transformar	to transform, change
unir	to unite
ajeno	not belonging to, detached
auténtico	authentic
bello	beautiful, fine
breve	brief, short
brillante	brilliant, shiny, sparkling
ciego	blind
complejo	complex, complicated 
complicado	complicated, complex
consciente	conscious, aware
convencido	convinced, persuaded
correspondiente	corresponding
cotidiano, diario	daily
cristiano	Christian
débil	weak
delicado	delicate
desconocido	unknown
encargado	in charge of
escaso	scarce, very little
extranjero	foreign, alien 
extremo	edge, border, end 
femenino	feminine, female
fijo	fixed, steady
fino	fine, delicate
fuerte	strong
habitual	usual, habitual, customary
hermoso	beautiful, lovely
independiente	independent, self-sufficient
infantil	of children, childlike, infantile
inmenso	immense, vast, huge
intelectual	intellectual
intenso	intense, acute
lejano	distant
literario	literary
loco	crazy, insane
muchísimo	great many, great amount
norteamericano	North American
notable	outstanding, noteworthy
objetivo	objective 
obligado	obliged, required
peligroso	dangerous
pendiente	aware of, pending
permanente	permanent
pesado	heavy, boring, tiresome
posterior	rear, backside
práctico	practical, skillful
previo	previous
reciente	recent
relacionado	related, regarding
sano, saludable	healthy, wholesome
seco	dry, arid
seguido	in a row, successive
semejante	similar, such, alike
sentado	seated
tremendo	tremendous, dreadful, huge
vecino	neighbor 
violento	violent
acaso	by chance, maybe
acerca	about, concerning
aparte	apart, aside, separately
definitivamente	definitely, finally
igualmente	equally
justamente	just, exactly
prácticamente	practically
únicamente, solamente	only
verdaderamente	truly
juez	judge
policía	police, police force, police officer
representante	representative 
alegría	joy, happiness
amistad	friendship
ausencia	absence
batalla	battle
belleza	beauty
busca	search, hunt
cadena	chain
caja	bank, box, safe
cama	bed 
cámara	camera, chamber
campaña	campaign
capa	layer, coat
característica	characteristic, aspect
carga	load, charge, cargo
columna	column, spine
compra	shopping, buy, purchase
conducta	conduct, behavior
costa	coast
crítica	criticism, critique
culpa	blame, fault
derecha	right, right hand
disciplina	discipline, subject
discusión	discussion, argument
disposición	disposal, disposition
entrevista	interview, meeting
escena	scene, stage, setting
espalda	back 
estación	station, season
estrella	star 
estructura	structure
fábrica	factory, manufacture
fe	faith
frecuencia	frequency
frontera	border, frontier
gana	desire
iglesia	church
inquietud	restlessness, anxiety
inteligencia	intelligence
interpretación	interpretation, interpreting
justicia	justice, fairness
juventud	youth
lista	list, roster, roll
llamada	call, knock
lluvia	rain
marca	mark, brand, trademark
mirada	gaze, look
misión	mission, task
moda	fashion, form
moneda	coins, currency
montaña	mountain 
norma	standard, pattern, norm
organización	organization
pasión	passion, desire
pérdida	loss
perspectiva	perspective
pierna	leg
pintura	painting, paint
plata	silver, money
plaza	square, marketplace
prensa	press
profundidad	depth, profundity
punta	tip, point
raíz	root
rama	branch, bough, limb
reacción	reaction
referencia	reference, allusion
resistencia	resistance, opposition
riqueza	riches, wealth
rueda	wheel
señal	sign, mark, token
sensación	sensation, feeling
sombra	shade, shadow
sorpresa	surprise
suma	sum, amount, summary
superficie	surface, area
tarde	late 
técnica	technique
tendencia	tendency, style
velocidad, rapidez	speed
ventaja	advantage, benefit
violencia	violence
virtud	virtue, quality
hambre	hunger, starvation
acceso	access, entry
accidente	accident, irregularity
acontecimiento	event, happening
alcance	reach, scope
alimento	food, nourishment
ánimo	zest, spirit, heart
aparato	apparatus, device
argumento	argument, plot
ataque	attack, raid
barco	boat
barrio	neighborhood, district
beneficio	benefit, profit
capítulo	chapter
muchacho	boy
círculo	circle, club
colegio	high school, college
comentario	remark, comment
comienzo	start, beginning
comportamiento	behavior, conduct
compromiso	compromise, engagement
consejo	advice, council, counsel
contenido	contents, content
cuento	story, tale
daño	harm, injury, damage
dedo	finger, toe, digit
defecto	defect
diálogo	dialogue, conversation
discurso	lecture, discourse, talk
dueño	owner, landlord 
ejercicio	exercise, practice
ejército	army
empleado	employee
empleo	work, job, occupation
enemigo	enemy
equilibrio	balance
espectáculo	spectacle, show
exceso	excess
experto	expert
extranjero	foreigner 
fracaso	failure, collapse
fruto	fruit, result
fuego	fire, gunfire
gasto	expense, expenditure
gesto	gesture
habitante	inhabitant
honor	honor, honesty
indio	Indian
individuo	individual, person
instante	instant, moment
intento	attempt, try
marco	frame, mark, setting
material	material 
matrimonio	marriage, married couple
método	method
nacimiento	birth, origin
organismo	organization, organism, human body
particular	particular, detail, individual 
pelo, cabello	hair
período	period, time
personal	personnel, staff, staffing 
placer	pleasure
plazo	deadline, installment
premio	prize, reward
presente	present, current 
puente	bridge
puerto	port, harbor
rasgo	feature, trait
rato	moment, while, time
régimen	regime, diet
remedio	alternative, cure, solution
rey	king
riesgo	risk
ruido	noise
salto	jump, hop, skip
signo	sign, mark, symbol
sonido	sound
sur	south
techo	ceiling, roof
temor, miedo	fear
territorio	territory
en torno a torno 		about, regarding		
tratamiento	treatment, processing
trato	treatment, manner, agreement
vehículo	vehicle, car
viento	wind, scent
volumen	volume
político	politician 
corte	court , cut 
margen	edge, margin, border, brink
aquél	that one over there 
aclarar	to clarify, clear up
acudir	to attend, go to, frequent
acumular	to accumulate, amass
adoptar	to adopt
alejar	to move away
amar	to love
añadir	to add
analizar	to analyze
apreciar	to appreciate
aprobar	to pass a test, approve
apuntar	to point, note, aim
arrancar	to start a machine, uproot
arrastrar	to drag, pull
arreglar	to fix, arrange
asumir	to assume, take on
atacar	to attack
atraer	to attract
atrever	to dare
basar	to base on, base upon
calcular	to calculate, figure out
cantar	to sing
casar	to marry
causar	to cause, bring about
ceder	to give way, yield
celebrar	to celebrate
cobrar	to charge money
cometer	to commit
componer	to compose, be part of
conceder	to grant, concede
condenar	to convict, condemn
confiar	to trust, confide
confirmar	to confirm
conformar	to conform
confundir	to confuse
contribuir	to contribute
convencer	to convince, persuade
declarar	to declare, testify
descansar	to rest
describir	to describe
destinar	to assign, appoint
destruir	to destroy, ruin
determinar	to determine, decide
devolver, retornar	to give back, to return something
gozar	to enjoy
dividir	to divide
dudar	to have doubt
ejercer	to practice, exercise
elevar	to elevate, raise
encargar	to entrust, take charge of
equivocar	to be wrong
estimar	to estimate, hold in esteem
experimentar	to experience, experiment
fabricar	to manufacture
facilitar	to facilitate
figurar	to appear, represent, figure in
fundar	to found, base
girar	to rotate, revolve
grabar	to record, engrave
hallar	to find out
ignorar	to be unaware
incorporar	to incorporate, include
integrar	to integrate, fit in
interrumpir	to interrupt
inventar	to invent, make up
justificar	to justify, excuse
juzgar	to judge
llorar	to cry
luchar	to fight, wrestle
manifestar	to express, show
mezclar	to mix
molestar	to bother, disturb, upset
nombrar	to name, appoint
operar	to operate
opinar	to think, be of the opinion
oponer	to oppose
ordenar	to put in order, organize
parar	to stop moving
pegar	to hit, stick on
perseguir	to pursue
poseer	to possess, own
practicar	to practice
proceder	to proceed, start
procurar	to try, seek
proteger	to protect
proyectar	to project
rechazar	to reject
reflejar	to reflect
reír	to laugh
repartir	to divide, deliver, distribute
requerir	to require
resistir	to resist, endure
robar	to rob, steal
rodear	to surround
saltar	to jump, leap, hop
solicitar	to solicit, request
someter	to subject, submit, subjugate
sonar	to sound, ring
soportar	to endure, stand something
sorprender	to surprise
sugerir	to suggest, hint at
temer	to fear
transmitir	to transmit, broadcast
trasladar	to move, transfer
vencer	to overcome, conquer
vestir	to wear, dress
volar	to fly
acostumbrado	accustomed
agradable	nice, pleasant
aislado	isolated
alejado	remote, distant, aloof
ancho	wide 
anciano	elderly, aged
aplicado	applied
armado	armed
artístico	artistic
avanzado	advanced
caliente	hot, warm, spirited
campesino	rural
casado	married
castellano	Castilian, Spanish
científico	scientific 
circular	to circulate, go around, flow 
ciudadano	citizen 
clave	key 
colectivo	collective, joint 
conforme	in agreement
cubierto	covered
decidido	determined, resolute
digno	worthy
divino	divine
efectivo, eficaz	effective
elemental	elemental, basic
elevado	elevated, high, lofty
entendido	understood
esencial	essential
espiritual	spiritual
establecido	established
estrecho	narrow
eterno	eternal
excesivo	excessive
fiel	faithful, loyal
firme	firm, steady
frecuente	frequent
incapaz	incapable
increíble	incredible, unbelievable
interesado	interested
íntimo	close, intimate
inútil	useless
magnífico	magnificent, splendid
maravilloso	wonderful, marvelous
múltiple	multiple, many
mundial	worldwide
nocturno	nocturnal, evening
no obstante obstante 		nevertheless		
oportuno	opportune, timely
opuesto	opposite, contrary
poderoso	powerful
precioso	beautiful, precious
preocupado	worried, concerned
primario	primary
probable	probable
redondo	round 
reducido	reduced, limited
relativo	relative 
respectivo	respective
revolucionario	revolutionary
rodeado	surrounded
roto	broken, torn
sabio	wise, learned
sagrado	sacred
satisfecho	satisfied
severo	severe
significativo	significant, meaningful
situado	situated, located
sólido	solid, strong
suave	soft, gentle, mild
suelto	loose
sujeto	subject, individual 
trabajador, obrero	worker, laborer
vacío	empty, vacant 
vestido	dressed 
afuera	outside
aparentemente	apparently
constantemente	constantly
efectivamente	in fact, actually, indeed
evidentemente	evidently, obviously
exclusivamente	exclusively
justo	fair, just 
a menudo 		often		
naturalmente	naturally
peor	worse, worst 
suficientemente	enough 
amante	lover
cliente	client, customer
especialista	specialist
guardia	guard, watch, lookout
paciente	patient
actuación	performance, acting
alternativa	alternative
angustia	anguish, distress
aparición	appearance, apparition
apariencia	appearance, aspect
arena	sand
biblioteca	library
bomba	bomb, explosion, pump
búsqueda	search
caída	fall, drop, falling
cárcel	jail, prison
carretera	highway, road
cifra	figure, number, amount
cinta	tape, ribbon, film, strip
claridad	clearness, clarity
cola	line, queue, tail
competencia	competition, contest
composición	composition, make-up, essay
corriente	current, common 
cualidad	quality, attribute
curiosidad	curiosity, quaintness
declaración	declaration, statement
demanda	petition, request, demand
desgracia	misfortune, bad luck
emoción	emotion, excitement
enseñanza	teaching, instruction
escala	scale, ladder, rank
espera	wait
esquina	corner
evolución	evolution, development
exigencia	requirement, demand
exposición	exhibition, display
fama	reputation, fame
felicidad	happiness
fila	line, row, file
filosofía	philosophy
firma	company, signature, signing
fórmula	formula
fortuna	fortune, fate
habilidad	ability, skill, talent
habitación	room, bedroom, habitat
humanidad	humanity, mankind
identidad	identity
independencia	independence
infancia	infancy, childhood
iniciativa	initiative
intervención	intervention
llegada	arrival
manifestación	protest, manifestation
mentira	lie
mezcla	mixture, blend
miseria	misery, wretchedness
muestra	proof, sample, sign
novedad	latest news, newness
nube	cloud
observación	observation
oposición	opposition
pobreza	poverty, lack, scarcity
poesía	poetry, poem
postura	posture, position, attitude
potencia	power, potential
precisión	precision
presentación	presentation, introduction
protección	protection
provincia	province, region
rapidez, velocidad	speed, velocity
raza	race, lineage
red	network, net, system
reflexión	reflection, thought
sección	section, cut
sensibilidad	sensitivity
sesión	session, meeting
tabla	chart, board, table, plank
tela	cloth, fabric
temperatura	temperature
temporada	season, period, time
tensión	tension, stress, strain
tragedia	tragedy
tranquilidad	tranquility, peace
víctima	victim, casualty
victoria	victory, triumph
vivienda	housing, dwelling
vocación	vocation, calling
área	area, zone 
alrededor	surrounding area, vicinity 
ámbito	sphere, space
aumento	increase, rise
avance, adelanto	advance, progress
borde	edge
bosque	forest
caballero	gentleman, knight
cálculo	calculation, calculus
canal	channel, canal
canto	singing, chant
castigo	punishment, penalty
cerebro	brain
clima	climate
comercio	commerce, trade
continente	continent
contrato	contract, agreement
crecimiento	growth, increase
crimen	crime, murder
cuello	neck, collar
desastre	disaster
descanso	rest, interval, break
descubrimiento	discovery
dibujo	drawing, sketch
diente	tooth, cog
dominio	power, control
ensayo	essay, rehearsal
entusiasmo	enthusiasm
escenario	stage, setting, scene
espejo	mirror, reflection
extremo	extreme 
factor	factor, cause, influence
familiar	relative 
funcionario	civil servant
género	sort, gender, genre
grito	cry, shout, scream
hábito	habit
hierro	iron
hilo	thread, yarn, wire
hombro	shoulder
hueso	bone
humor	mood, humor
impulso	impulse, momentum
índice	index, forefinger
informe	report
ingreso	entrance, admission, income
largo	length 
lector	reader, lecturer
llamado	call, calling
local	place, quarters 
lujo	luxury
mecanismo	mechanism
mérito	worth, merit
monte	mountain 
montón	lot of, heap, pile
muchacho	boy
mueble	piece of furniture
muro	outer wall, rampart
oficio	job, occupation, function
oído	hearing, ear
olor	smell, odor, fragrance
órgano	organ
pago	payment
paisaje	landscape
pájaro,ave	bird
palacio	palace
patio	courtyard, playground, yard
patrón	employer, landlord, patron saint, pattern
pecho	chest, breast
permiso	permission, permit
y pico 		and a bit	
polvo	dust, powder
prestigio	prestige
primo	cousin
privilegio	privilege
procedimiento	procedure, proceedings
progreso	progress
reconocimiento	recognition, acknowledgment
reflejo	reflection 
regreso, retorno	return
revés, al revés 		backwards, upside down, inside out		
sacerdote	priest
sacrificio	sacrifice
seno	breast
significado	meaning
símbolo	symbol
sueldo	salary, pay
sujeto	fastened, subject to 
testigo	witness
tío	uncle, guy
tiro	throw, shot
traje	suit, dress
transporte	transportation, transport
triunfo	triumph, victory
vacío	emptiness, void 
valle	valley
vecino	nearby, neighboring 
vuelo	flight
aconsejar	to advise, counsel
acostumbrar, soler	to be accustomed to
acusar	to accuse
adelantar	to move forward
admirar	to admire
agotar	to exhaust, wear out, run out
agradecer	to thank for
agregar	to add, gather
aguantar	to endure, put up with
ajustar	to adjust, tighten
alimentar	to feed, support
alterar	to alter, modify
ampliar	to enlarge, increase, expand
apartar	to move away, separate
aportar	to provide, contribute
arrojar, lanzar	to throw , to hurl
ascender	to ascend, be promoted
asociar	to associate with
aspirar	to aspire, want
atribuir	to attribute
averiguar	to investigate, find out
borrar	to erase
captar	to capture, attract
carecer	to lack
chocar	to crash into, collide with
coger	to hold, take, catch
colaborar	to collaborate, work together
combatir	to fight against
concebir	to conceive, understand
confesar	to confess, admit
constar	to consist of, comprise
corregir	to correct, rectify
criar	to bring up, rear
deber	duty, obligation 
denominar, llamar	to call, name
depositar	to deposit, place, store
derivar	to derive, come from
descender	to descend
desconocer	to not know, not recognize
despedir	to dismiss, to say goodbye to
desplazar	to replace, move, shift
desprender	to detach, release, remove
dictar	to dictate, announce
disminuir	to decrease, diminish
distribuir	to distribute, deliver
doblar	to bend, turn
emitir	to emit, give off
empeñar	to pawn, pledge, engage
empujar	to push, shove
encerrar	to shut in
engañar	to trick, deceive
enterar	to find out 
esconder	to hide, conceal
examinar	to examine, inspect
explotar	to explode, exploit
fallar	to fail, miss
forzar	to force
gastar	to spend money
golpear	to hit, strike
gritar	to shout
huir	to flee, run away
hundir	to sink, submerge
implicar	to implicate, imply
impulsar	to push, promote, drive
inclinar	to bow, tilt, incline
ingresar	to join, deposit, admit
invadir	to invade, overcome
invertir	to invest
investigar, indagar	to investigate 
modificar	to modify
obedecer	to obey
ocultar	to hide
padecer	to suffer
parecer	opinion, looks 
pasear	to go for a walk, ride
pelear	to fight, struggle
penetrar	to penetrate
percibir, notar	to notice
precisar	to do exactly, specify
prohibir	to prohibit, forbid
prometer	to promise
proporcionar	to provide, supply
provenir	to come from, be from
quejar	to complain
quemar	to burn
reaccionar	to react
reclamar	to demand, require
recomendar	to recommend
recurrir	to resort to
registrar	to register, record [also inscribir]
relacionar	to relate
rendir	to yield, to produce
renunciar	to give up, renounce
reproducir	to reproduce, repeat
respirar	to breathe
revelar	to reveal, disclose
revisar	to check, revise, inspect
saber	knowledge 
saludar	to greet, say hello
satisfacer	to satisfy
sobrevivir	to survive, outlive
soñar	to dream
sospechar	to suspect, suppose
sumar	to add up, amount to
suspender	to suspend, hang, fail
sustituir	to substitute, replace
traducir	to translate
transcurrir	to occur, pass
ubicar	to find, locate
abandonado	abandoned
absurdo	absurd
abundante	abundant, plentiful
académico	academic
agresivo	aggressive
agudo	sharp, acute
alegre	happy, lively, cheerful
anónimo	anonymous
apropiado	appropriate
atractivo	attractive 
caído	fallen
cansado	tired, tiresome
característico	characteristic
católico	Catholic
compuesto	composite, mixed
comunista	Communist
considerable	considerable
creciente	growing, increasing
cruel	cruel, harsh
cuadrado	square
culpable	guilty
definido	definite
democrático	democratic
desagradable	unpleasant
desarrollado	developed, grown
desesperado	desperate, hopeless
desierto	desert 
desnudo	nude, naked
distante	distant, far, remote
doloroso	painful
encerrado	locked up
envuelto	wrapped
equivocado	mistaken, wrong
específico	specific
espontáneo	spontaneous
estricto	strict, rigorous
extenso	extensive, large
externo	external, outward
favorable	favorable, suitable
feo	ugly, nasty, rude
formal	formal, polite
fresco	cool, healthy, fresh 
generoso	generous
gordo	fat, thick
grueso	thick 
humilde	humble, modest
idéntico	identical
impresionante	impressive, astonishing
indígena	indigenous, native
industrial	industrial
infinito	infinite 
injusto	unfair, unjust
judío	Jewish
masculino	masculine, manly, male
mero	mere
modesto	modest, humble
moreno	dark, brown
mutuo	mutual
obrero	worker, laborer  [also trabajador]
occidental	occidental, western
oculto	hidden, occult
ordenado	organized, clean
ordinario	vulgar, ordinary
organizado	organized
orgulloso	proud, arrogant [also soberbio]
parado	stopped, standing
paralelo	parallel
pintado	painted
poquito	little bit
previsto	foreseen, planned
prohibido	prohibited
querido	dear, beloved
razonable	reasonable
remoto	remote, far-off
repetido	repeated
resuelto	resolved, determined
rígido	rigid, stiff, firm
salvaje	wild, savage, uncultivated
secundario	secondary
sensible	sensitive, sentient
solitario	solitary, lonely
sorprendente	surprising, astonishing
sucesivo	successive, following
tonto	stupid, dumb
válido	valid
valioso	valuable, precious
variado	varied, mixed
acá	here
actualmente	now, at present
adentro, dentro		inside
plenamente	fully
posteriormente	afterwards
principalmente	principally, mainly
repente: de + repente 		suddenly		
sencillamente	simply
sumamente	extremely, highly
últimamente	lately, recently
etcétera	etcetera
colega	colleague
comerciante	merchant, businessman
guía	guide, leader
líder	leader
pariente	relative 
actualidad	present time
afirmación	statement, assertion
ambición	ambition
amenaza	threat
anécdota	anecdote
aplicación	application
asociación	association
atmósfera	atmosphere, environment
banda	musical band, sash
bandera	flag
botella	bottle, flask
broma	joke
casualidad	chance, coincidence
caza	hunting 
combinación	combination
comisión	commission, committee
comodidad	comfort, convenience
compañera	female companion
concepción	conception
conferencia	conference, lecture
consulta	consultation, advice
contradicción	contradiction
convicción	conviction
creencia	belief
criatura	creature, child
cuerda	cord, rope
dama	lady, dame
danza	dance
debilidad	weakness
década	decade
desaparición	disappearance
destrucción	destruction
deuda	debt
dignidad	dignity
distribución	distribution
doña	courtesy title , Mrs.
edición	edition, publication
ejecución	performance, execution
entrega	delivery
escritura	writing, scripture
estancia	stay, stance, ranch
expectativa	expectation, hope, prospect
explosión	explosion
extensión	extension, area, expanse
fantasía	fantasy, fancy
fase	phase, stage
garantía	guarantee, warranty
gloria	glory, fame
herencia	inheritance, legacy
herida	wound, injury
herramienta	tool
huella	trace, track, footstep
inclinación	slope, incline, tendency
instalación	installation, facilities
instancia	application, request
intensidad	intensity, force
inversión	investment, outlay
invitación	invitation
jornada	working day, shift
lágrima	tear, teardrop
lata	tin can
leyenda	legend
liberación	liberation
limpieza	cleanliness, purity
llave	key, faucet, wrench
locura	madness, insanity
lógica	logic
madrugada	dawn, daybreak [also alba]
mancha	stain, spot
maravilla	wonder, marvel
media	average; a m.: halfways
meta	goal, aim, purpose
nieve	snow
ocupación	occupation, use
oferta	offer, bid, supply
ola	wave, billow
onda	wave, ripple
opción	option, choice
oreja	ear
orilla	shore, edge
oscuridad	darkness
paciencia	patience
pantalla	screen, monitor
pata	leg, paw
patria	native land, fatherland
pelota	ball
pensión	pension, boarding house
pista	clue, track, trace
pluma	pen, feather
posesión	possession
preparación	preparation, training
promesa	promise
proporción	proportion
propuesta	proposal, proposition
protesta	objection, protest
reina	queen
risa	laugh, chuckle
roca	rock
rodilla	knee
ruina	ruin, collapse
ruptura	break-up, rupture
ruta	route
selva	forest, jungle
separación	separation
simpatía	sympathy, affinity
soledad	loneliness, solitude
tarjeta	card
tesis	thesis, exposition
tía	aunt
torre	tower
totalidad	whole, totality
transformación	transformation
tristeza	sadness
tropa	troops, forces
tumba	tomb, grave
urgencia	urgency
vaca	cow
variedad	variety
vela	candle, sail, vigil
vergüenza	embarrassment
viuda	widow
ala	wing, flank
aceite	oil
afán	eagerness, zeal, effort
afecto	affection, fondness
almacén	warehouse, store
ángulo	angle
anuncio	advertisement, announcement
apellido	last name
arco	arch, arc, bow
asiento	seat, chair
ave,pájaro	bird
azar	random, chance, hazard
bienestar	wellbeing, welfare
bolsillo	pocket
cadáver	corpse, body
candidato	candidate
caos	chaos
capitán	captain, chief
cariño	love, affection
centímetro	centimeter
cierre	zipper, closing
código	code
combate	combat, battle, fight
consumo	consumption
contraste	contrast
creador	creator
cristal	glass, crystal, window
cultivo	cultivation, crop
debate	debate
delito	crime, offense
desorden	disorder, mess
despacho	office, study
diseño	design
duro	money 
eco	echo, response
episodio	episode, incident
escándalo	scandal
esclavo	slave
esquema	outline, diagram, plan
establecimiento	establishment
fantasma	ghost, phantom
funcionamiento	functioning, operation
ganado	livestock, cattle
giro	turn, draft, expression
héroe	hero
hielo	ice
homenaje	homage, tribute
horario	schedule, timetable
horizonte	horizon
impacto	impact
inconveniente	inconvenience, drawback
intercambio	exchange, interchange
laboratorio	laboratory
líquido	liquid
mando	command, authority
manejo	handling, management
mapa	map
matiz	shade, tint, nuance
milagro	miracle
mito	myth
muerto	dead person 
núcleo	nucleus, core
objetivo	objective, impartial 
odio	hatred
orgullo	pride
oriente	East
palo	stick, pole
panorama	panorama, landscape
paquete	package, packet
partidario	supporter, partisan
pasaje	fare, passage, lane
paseo	walk, ride
perdón	forgiveness, pardon
perfil	profile, outline
pez	fish 
planeta	planet
rayo	ray, beam, lightning
rechazo	rejection, refusal
recorrido	journey, itinerary, route
registro	register, record
reino	kingdom, reign
relato	tale, story
retrato	portrait, photograph
rigor	harshness, rigor
rincón	corner, nook
rostro	face, countenance
rumbo	direction, course, bearing
sabor	taste, flavor, sensation
síntoma	symptom
socio	member, partner
talento	talent, skill
taller	workshop, shop
testimonio	testimony, evidence
toro	bull
tratado	treaty, treatise
turno, en turno a 		turn; shift		
varón	male, man
vaso	drinking glass, vase
vestido	dress 
vidrio	glass, pane
voto	vote
pintor	painter
cura	priest , cure 
doscientos	two hundred
abarcar	to encompass, comprise
abordar	to board, get in/on
absorber	to absorb, soak up
acceder	to consent, agree, accede
acomodar	to accommodate, be/make comfortable
adaptar	to adapt
agarrar	to grasp, catch
amenazar	to threaten
apagar	to turn off, extinguish
apretar	to squeeze, tighten, compress
aproximar	to come near, closer
asomar	to appear, show, stick 
atar	to tie 
avisar	to notify [also notificar]
bailar	to dance
brindar	to offer
calificar	to grade, rate, qualify
callar	to be/make quiet
caracterizar	to characterize, portray
castigar	to punish
cesar	to cease, stop
colgar	to hang up
combinar	to combine
competir	to compete
comportar	to behave
comprometer	to compromise
conquistar	to conquer, win over
contratar	to hire, contract
curar	to cure
denunciar	to denounce
desempeñar	to carry out, fulfill
deshacer	to undo, destroy, take apart
designar	to designate
dibujar	to draw, sketch
disparar	to shoot at
divertir	to amuse, entertain
doler	to hurt
ejecutar	to execute, carry out
emprender	to undertake, embark on
encender	to turn on
envolver	to wrap
equilibrar	to balance
escoger	to choose
especializar	to specialize, major in
estallar	to break out, explode, start
expulsar	to expel, throw out
extraer	to extract, take out
favorecer	to favor, help
fracasar	to fail, to be unsuccessful
garantizar	to guarantee
generar	to generate
gobernar	to govern
imitar	to imitate, copy, mimic
impresionar	to impress
inaugurar	to inaugurate, start
influir	to have influence
inspirar	to inspire, inhale
juntar	to put togerther, to get together [also reunir]
llover	to rain
optar	to choose, opt for
orientar	guide, show the way
otorgar	to give, grant, award
portar	to behave [se], carry
prender	to turn on, apprehend
prever	to foresee, anticipate, forecast
prolongar	to extend, prolong
protestar	to protest, object
quebrar	to break, bend, weaken
reconstruir	to reconstruct
retener	to keep, retain
secar	to dry
situar	to situate, place, locate
soltar	to release, loosen, let out
solucionar	to solve, settle
tapar	to cover, wrap
variar	to change, vary
vigilar	to watch over, guard
aburrido	boring, bored
admirable	admirable
adolescente	adolescent 
aéreo	aerial, air
agotado	tired, used up, sold out
amargo	bitter, sour, painful
aparente	apparent
atento	attentive, careful, polite
ausente	absent
autónomo	autonomous
bárbaro	savage, horrible
blando	soft, limp, gentle
bravo	fierce, angry
bruto	brutal, coarse, clumsy
cálido	warm
comprometido	committed, engaged
confuso	confused, mixed up
conservador	conservative
consiguiente	consequent
convencional	conventional
crudo	raw, crude, natural
culto	cultured, educated 
decisivo	decisive, conclusive
deportivo	sports, sporty
dorado	golden, gold-plated
dormido	asleep, sleeping
escolar	school, scholastic
escondido	hidden
espectacular	spectacular
espléndido	splendid, generous
estable	stable, steady
estético	esthetic
exagerado	exaggerated
existente	existing
exquisito	exquisite, superb
fatal	fateful, deadly, awful
filosófico	philosophical
frustrado	frustrated
gigantesco	giant, gigantic
hábil	skillful, clever
harto	fed up with
herido	wounded, injured 
hondo	deep
hueco	hole, cavity 
húmedo	humid, damp
ideológico	ideological
ilustre	renowned, illustrious
imprescindible	essential, indispensable
inclinado	inclined, slanting
incómodo	uncomfortable
inconsciente	unconscious, thoughtless
indiferente	indifferent
inesperado	unexpected, unforeseen
inocente	innocent, naïve
inquieto	restless, anxious
judicial	judicial
jurídico	legal, juridical
juvenil	young, juvenile
legítimo	legitimate
leve	slight, trifling, light
ligado	linked, joined
lindo	pretty, nice, lovely
luminoso	bright, luminous
maduro	mature, ripe
mágico	magic, magical
marino	marine, naval
mediado	mid, middle
metálico	metallic
mezclado	mixed
misterioso	mysterious
municipal	municipal, town
noble	noble 
obvio	obvious
peculiar	peculiar
pensado	thought-out, designed
prestado	borrowed, lent
prolongado	prolonged, lengthy
prudente	sensible, prudent
químico	chemical
realista	realistic
recto	right, straight, honest
reservado	reserved, booked
riguroso	rigorous, severe
sincero	sincere
singular	single, singular
socialista	socialist
sonoro	loud, resounding
sordo	deaf, dull
supremo	supreme
sutil	subtle
teórico	theoretical
tierno	tender, soft
tímido	timid, shy, half-hearted
trágico	tragic
transparente	transparent, clear
vasto	vast, immense, huge
voluntario	voluntary, volunteer
vulgar	vulgar, common, banal
afortunadamente	luckily, fortunately
anteriormente	previously [also previamente]
ciertamente	certainly, indeed
continuamente	continuously
enfrente	in front of
enseguida	immediately, at once
estrictamente	strictly
francamente	frankly, openly
libremente	freely
particularmente	particularly, personally
previamente, anteriormente	previously
recientemente	recently
relativamente	relatively
seguida, en seguida 		right away, at once		
este	East 
ayudante	helper, assistant
protagonista	protagonist, main character
visitante	visitor
aceptación	acceptance, approval
agencia	agency, branch
alimentación	feeding, food
armonía	harmony
arquitectura	architecture
asistencia	attendance, assistance
aspiración	ambition, aspiration
atracción	attraction
avenida	avenue
barra	bar, rod, rail
barrera	barrier, obstacle
basura	garbage, rubbish
bebida	drink, beverage
boda	marriage, wedding
bola	ball, sphere
bondad	goodness, kindness
bota	boot, wineskin
campana	bell
cercanía	nearness, proximity
certeza	certainty
charla	talk, chat
circulación	circulation, traffic
coincidencia	coincidence
conquista	conquest
convivencia	coexistence, living together
corona	crown
correspondencia	correspondence, connection
cosecha	harvest, crop
crónica	account, chronicle
cruz	cross, burden
cuota	quota, share, dues
curva	curve
democracia	democracy
demostración	demonstration
denuncia	accusation, complaint, denunciation
dependencia	dependence, dependency
derrota	defeat, loss
descripción	description
desesperación	desperation, exasperation
determinación	determination
dictadura	dictatorship
docena	dozen
doctrina	doctrine, teachings
dosis	dose
eficacia	efficiency, effectiveness
entidad	entity
escalera	stairs, ladder
esfera	sphere, globe
especialidad	specialty, specialized field
estrategia	strategy
fiebre	fever, excitement
fuga	flight, escape
geografía	geography
gestión	management, step, negotiation
gota	drop
gravedad	seriousness, gravity
guitarra	guitar
hierba	herb, grass, weed
huelga	strike, protest
humedad	humidity
identificación	identification
igualdad	equality
incertidumbre	uncertainty
índole	nature, temperament
injusticia	injustice
intimidad	private life, intimacy
invasión	invasion
joya	jewel, treasure
laguna	lagoon
limitación	limitation
madurez	maturity, ripeness
magnitud	magnitude, extent
maniobra	maneuver, operation
manzana	apple, city block
mercancía	goods, merchandise
misa	religious mass
mosca	fly 
muchacha	girl
naranja	orange 
nave	spacecraft, ship
noción	notion, idea
novia	girlfriend, bride
oración	prayer
orientación	orientation, direction
palma	palm tree, palm
pausa	pause
precaución	caution, forethought
preferencia	preference
prenda	piece of clothing
presa	dam, prisoner 
pretensión	pretension, claim
prisión	prison, imprisonment
propaganda	advertising, propaganda
publicación	publication
publicidad	advertising, publicity
queja	complaint
rabia	rage
realización	fulfillment, realization
recomendación	recommendation
reforma	reform, improvement
residencia	residence
resolución	resolution
sabiduría	wisdom, knowledge
semilla	seed
señorita	young woman
sentencia	legal sentence, judgment
síntesis	synthesis
solidaridad	solidarity, togetherness
sonrisa	smile
sospecha	suspicion
sucesión	succession, series
sustancia	substance, essence
tecnología	technology
tentación	temptation
tormenta	storm
trampa ; hacer trampa		trick, trap; to cheat		
tribu	tribe
utilidad	usefulness, utility
variación	variation
vigilancia	surveillance, vigilance
habla	speech, talking
abandono	abandonment, desertion
abuso	abuse, misuse
acento	accent, stress
adiós	goodbye
ahorro	saving, thrift
amo	master, boss 
antecedente	antecedent
aprendizaje	learning, apprenticeship
arreglo	arrangement
aviso	warning
barro	clay, mud
botón	button
cabello	hair [also pelo]
cable	cable, wiring
cajón	drawer
camión	truck, van, tanker
cansancio	tiredness, weariness
capricho	caprice, whim
celo	zeal, jealousy
cementerio	cemetery, graveyard
chiste	joke, funny story
choque	crash, collision
cigarrillo	cigarette
ciudadano	community, citizen 
colaborador	collaborator
complejo	complex 
componente	component, ingredient
concurso	competition, gathering
contexto	context
coro	choir, chorus
cruce	crossing, intersection
cuartel	quarters, barracks
cuchillo	knife
cuero	leather, skin
culto	worship, cult 
cumplimiento	fulfillment, compliment
depósito	deposit, sediment
desafío	challenge, provocation
desprecio	contempt, disdain
diablo	devil
eje	axis, shaft, crux
ejemplar	exemplary, model 
empresario	manager, entrepreneur
énfasis	emphasis
entorno	environment, surroundings
espectador	spectator, onlooker
esposo	husband, spouse
estímulo	stimulus, encouragement
estómago	stomach
experimento	experiment
ferrocarril	railway
filósofo	philosopher
foco	focus
fresco	freshness, coolness 
fundamento	foundation, ground
genio	genius, temper, genie
grano	grain, kernel
humo	smoke
impuesto	tax
incendio	fire, conflagration
inicio	beginning, start
instinto	instinct
invitado	guest
juguete	toy
labio	lip
lago	lake
lazo	bow, knot, tie, lasso
león	lion
mediodía	noon, midday
monumento	monument
nervio	nerve
nieto	grandchild
obstáculo	obstacle
olvido	forgetfulness, omission
pacto	pact, agreement
papa	Pope , potato 
paraíso	paradise
pasillo	hall, corridor
pecado	sin
pedazo	piece, bit
porvenir	future, time to come
pozo	well, shaft
prejuicio	prejudice
presupuesto	budget
pretexto	pretext, excuse
príncipe	prince
propietario	owner
refugio	shelter, refuge
requisito	prerequisite, requirement
respaldo	support, backing, back
resumen	summary
robo	theft, robbery
saco	sack, bag, plunder
saludo	greeting
sello	stamp, seal
sombrero	hat, sombrero
suceso	event, incident
sufrimiento	suffering
tejido	fabric, tissue
tesoro	treasure, thesaurus
tránsito	traffic, transit
traslado	transfer
tribunal	court
tronco	trunk, torso
trozo	piece, chunk
tubo	tube, pipe
túnel	tunnel
vapor	vapor, steam
verso	verse, poem
vicio	vice, bad habit, defect
arquitecto	architect
científico	scientist 
corredor	broker, corridor, runner
investigador	researcher, investigator
obrero	working class 
técnico	technician 
postre; a la postre 		dessert; in the end
abrazar	to hug, embrace
abundar	to be plentiful
acentuar	to accent, stress
acoger	to welcome, accept
adivinar	to guess, solve
afrontar	to face, confront
ahogar	to drown, choke, flood
ahorrar	to save 
alargar	to enlarge, elongate
alegrar	to be/make happy
alzar	to lift, raise
anotar	to annotate, jot, note
armar	to arm, put together
asimilar	to assimilate
asustar	to frighten, scare
autorizar	to authorize, legalize
brillar	to shine, twinkle, be outstanding
brotar	to sprout
calentar	to warm, heat
cansar	to tire, annoy
centrar	to center, focus, base on
concretar	to specify, materialize, fulfill
contraer	to contract, shrink, abbreviate
conversar	to converse, talk
convivir	to coexist
convocar	to convene, summon
deducir	to deduce, infer
derrotar	to defeat, beat
descartar	to discard, reject, rule out
desviar	to deviate, divert, change
detectar	to detect
diferenciar	to differentiate, distinguish
difundir	to spread out
diseñar	to design, develop
distraer	to distract
efectuar	to carry out, cause to happen
encantar	to be very pleasing to
enriquecer	to enrich
enterrar	to bury
entretener	to entertain, amuse
esforzar	to make an effort, exert oneself
estimular	to stimulate, encourage
exagerar	to exaggerate
extrañar	to miss, long for
flotar	to float, flutter
frenar	to brake, restrain
generalizar	to generalize, popularize
guiar	to guide, lead, steer
habitar	to inhabit
heredar	to inherit
iluminar	to illuminate, light up
imprimir	to print
inducir	to lead to, induce
jurar	to swear, take an oath
lamentar	to regret
librar	to liberate, set free
lucir	to show off, shine
originar	to give rise to, cause
pescar	to fish
picar	to bite, sting, itch, chop
pisar	to step on
planear	to plan
plantar	to plant
presionar	to press, pressure
privar	to deprive of
proclamar	to proclaim
progresar	to progress
promover	to promote
proseguir	to continue, carry on
proveer	to provide
redactar	to edit, write, compose
reflexionar	to reflect, consider on
reiterar	to reiterate, repeat
relatar	to tell, narrate
remontar	to go back to time
reparar	to repair, to mend, to fix
rescatar	to rescue, save
residir	to reside, live in
restar	to subtract, minimize
retroceder	to go back
rezar	to pray, recite
sacrificar	to sacrifice
sacudir	to shake, jolt
sembrar	to sow, plant
sobrar	to be too much, left over
sonreír	to smile
sujetar	to fasten, attach, hold
suprimir	to suppress, delete
tejer	to sew, weave
tolerar	to tolerate, put up with
tragar	to swallow
transportar	to transport, carry
trazar	to draw, trace
triunfar	to triumph
tropezar	to trip, stumble
valorar	to value
violar	to violate, trespass, rape
altísimo	very high, tall
ambicioso	ambitious, greedy
amoroso	loving, affectionate
animado	excited, lively
ansioso	anxious eager
auxiliar	auxiliary, ancillary
británico	British
brusco	brusque, abrupt, sudden
callado	quiet, reserved
casero	homemade
célebre	famous, renowned
colgado	hanging
cómico	comic
contemporáneo	contemporary
contradictorio	contradictory
décimo	tenth
delgado	thin, skinny
delicioso	delicious, delightful, charming
despacio	slow, slowly
destacado	outstanding, leading
dicho	saying, proverb 
discreto	discreet, tactful
disponible	available
distinguido	distinguished
dotado	endowed, gifted
dudoso	doubtful, dubious
ejecutivo	executive
electoral	electoral
electrónico	electronic
enamorado	in love
encantado	pleased, delighted
encendido	turned on, burning
enérgico	energetic, vigorous
espantoso	frightening, dreadful
estupendo	marvelous, stupendous
estúpido	stupid, idiotic
financiero	financial
flexible	flexible
formidable	formidable, tremendous
frágil	fragile, weak
genial	brilliant, inspired
geográfico	geographical
gracioso	funny, charming, amusing
grato	agreeable, pleasant
heroico	heroic
honesto	honest
ignorante	ignorant
ilustrado	learned, illustrated
indirecto	indirect
innecesario	unnecessary
innumerable	innumerable, countless
insoportable	unbearable, intolerable
insuficiente	insufficient
intacto	intact
intermedio	interim, intermediate 
interminable	endless, interminable
laboral	labor, industry 
lamentable	regrettable
mediano	average, medium, ordinary
miserable	wretched, miserable
molesto	annoyed, bothered, upset
mortal	mortal, lethal, deadly 
mudo	mute, silent
notorio	notorious, noticeable
pacífico	peaceful
pálido	pale, ghastly, faded
pasajero	passenger 
policial	police 
potente	potent, powerful
preferible	preferable
preso	prisoner 
procedente, proveniente	coming from
psicológico	psychological
quemado	burned, burnt
quieto	still, motionless, calm
referente	concerning
regional	regional
repentino	sudden [also súbito]
restante	remaining
ridículo	ridiculous, absurd 
rotundo	categorical
satisfactorio	satisfactory
sexto	sixth
silencioso	quiet, silent
simbólico	symbolic
solemne	solemn
soltero	single, not married
sorprendido	surprised
sostenido	sustained, steady
tardío	late, belated
teatral	theatrical
temporal	temporary
tenso	tight, tense
usado	worn out, old, used
vago	vague
valiente	brave, courageous, bold
vano	vain, useless
vegetal	plant, vegetable 
verbal	verbal, oral
vertical	vertical, upright
vinculado	connected
automáticamente	automatically
concretamente	specifically, exactly
curiosamente	strangely, funnily enough
desgraciadamente	unfortunately
difícilmente	with difficulty
habitualmente	habitually
indudablemente	doubtless, undoubtedly
ojalá	I hope that
permanentemente	permanently
propiamente	exactly, properly
seriamente	seriously
sucesivamente	successively, step by step
tranquilamente	calmly, peacefully
ama	housekeeper, housewife
asistente	assistant
cantante	singer
civil	civilian 
descendiente	descendant
dirigente	leader, director, manager
abundancia	abundance
advertencia	warning, notice
afición	fondness, interest
agresión	aggression, attack
alarma	alarm
aldea	small village
alfombra	rug, carpet mat
ansiedad	anxiety
apertura	opening, beginning
audiencia	audience, hearing
autonomía	autonomy, range
bala	bullet, shot
barba	beard
caña	cane, reed
carencia	lack, shortage [also falta]
catástrofe	catastrophe
celebración	celebration
célula	cell 
cintura	waist
clave	key 
comedia	comedy, play, pretense
complicación	complication
concesión	awarding, concession
conexión	connection, relationship
confesión	confession, admission
constancia	perseverance
continuidad	continuity
conveniencia	convenience, usefulness
corbata	tie, sash
decadencia	decline, decay
depresión	depression, slump
desconfianza	distrust
diversión	fun, entertainment
envidia	envy
escasez	scarcity, shortage
espada	sword
estabilidad	stability
estadística	statistic
estatua	statue
excelencia	excellence
feria	fair, festival
fibra	fiber, grain
ficción	fiction
finalidad	purpose, aim
fortaleza	fortress, strength
frustración	frustration
galería	gallery, balcony
gallina	hen, coward
garganta	throat, gorge
grandeza	greatness, size
grasa	grease, fat
hembra	female, woman
ideología	ideology
ignorancia	ignorance
indiferencia	indifference
inspiración	inspiration, inhalation
jerarquía	hierarchy, rank
junta	meeting, conference, seam
justificación	justification
lámpara	lamp
lana	wool
lástima	shame, pity
licencia	license, permission
magia	magic
manga	sleeve
máscara	mask
matemática	mathematics
mejora	improvement
mentalidad	mindset, mind
molestia	bother, nuisance, trouble
orquesta	orchestra, dance band
paja	straw, thatching
pauta	guideline, rule, standard
pelea	fight, quarrel
permanencia	permanence, tenure
persecución	pursuit, persecution
pesadilla	nightmare
pesca	fishing
petición	request, petition
placa	plaque, plate, badge
plenitud	fullness, abundance
porción	part, portion, share
porquería	filth, junk
previsión	forecast, precaution
prima	female cousin, down payment
prisa	hurry
proximidad	proximity
proyección	projection, screening
pureza	purity, chastity
rata	rat
raya	line, ray, stripe
receta	recipe, prescription
recuperación	recovery, recuperation
renta	income, rent 
república	republic
respiración	respiration, breath
rutina	routine
secuencia	sequence
sed	thirst
seda	silk
seriedad	seriousness
sierra	mountain range, saw
tapa	cover, lid
taza	cup, bowl
timidez	shyness, timidity
tinta	ink
tontería	stupidity, stupid thing [also estupidez]
traición	treason, betrayal
transición	transition
trascendencia	transcendent nature, significance
trayectoria	trajectory, path
uña	nail
venganza	revenge, vengeance
de veras vera 		really, for real
acero	steel
adorno	decoration, adornment
aficionado	fan, devotee
agujero	hole, opening
alcalde	mayor
aliento	breath, courage, spirit
almuerzo	lunch
amanecer	daybreak, dawn 
anillo	ring
aplauso	applause, praise, acclaim
archivo	archive, file, filing cabinet
ascenso	promotion, climb
asesinato	murder, assassination
asesino	killer, assassin
atractivo	attraction, charm 
auxilio	help, aid, assistance
balance	outcome, balance
bando	faction, side
beso	kiss
billete	ticket, bill, note
brillo	shine, twinkling, sparkle
bronce	bronze
cáncer	cancer
cañón	canyon, cannon
cartel	poster
cartón	cardboard, carton, sketch
casco	helmet
castillo	castle
cauce	riverbed, ditch
cemento	cement, concrete
centenar	hundred 
cerdo	pig, sow, slob
cerro	hill
comedor	dining room
congreso	congress
coraje	courage, toughness
costado	side, flank
costo	price, cost, expense
crítico	critic 
cuaderno	notebook, workbook
defensor	defender
demonio	demon, devil
desayuno	breakfast
domicilio	residence, address
dormitorio	bedroom, dormitory
empeño	insistence, determination
encanto	charm, spell
enfrentamiento	confrontation
engaño	deceit, falsehood, hoax
entendimiento	understanding
escudo	shield, coat of arms
exilio	exile
filo	cutting edge
fragmento	fragment, passage
globo	balloon, globe
guante	glove
hallazgo	finding, discovery
horno	oven, furnace
imperio	empire, fortune
incidente	incident
indicio	indication, sign
infierno	hell, inferno
ingenio	ingenuity, talent, wit
invento	invention
ladrillo	brick
lápiz	pencil
logro	success, achievement
macho	male, manliness
maíz	corn, maize
malestar	discomfort, unease, unrest
mandato	mandate, order, command
manifiesto poner de manifiesto 		to show	
ministerio	ministry
mono	monkey
monstruo	monster, monstrosity
nido	nest
nudo	knot
obispo	bishop
observador	observer
pánico	panic
párrafo	paragraph
patrimonio	patrimony, inheritance
petróleo	oil, petroleum
plano	flat, plain, even, level 
plomo	lead, bullet
pollo	chicken
porcentaje	percentage
portador	bearer, carrier
prisionero	prisoner
pulmón	lung
quehacer	task, job, chore
rango	rank, range
rastro	track, sign, flea market
razonamiento	reasoning
recinto	grounds, precincts
reparto	distribution, delivery
restaurante	restaurant
reto	challenge, defiance
retorno	return [also regreso]
rito	rite, ritual
salario	salary, wages
seguro	insurance 
suicidio	suicide
susto	fright, scare
televisor	television set
timbre	doorbell, bell, seal, stamp
toque	touch, ringing, warning
trámite	procedure, step, requirement
tramo	section, stretch, plot
transcurso	passing, course, lapse
trayecto	trajectory, course, path
viajero	traveler, passenger
vientre	womb, belly
vigor	force, strength, vigor
vínculo	tie, bond, link
cazador	hunter
conductor	driver, conductor
enfermero	nurse
historiador	historian
pastor	shepherd, pastor
diecisiete	seventeen
noventa	ninety
quinientos	five hundred
trescientos	three hundred
excepto	except for
acelerar	to accelerate, speed up
acertar	to get right
acostar	to put/go to bed
adorar	to worship, adore
agitar	to shake, move
aislar	to isolate, insulate
alentar	to encourage
aliviar	to lighten, relieve, comfort
alternar	to alternate
aludir	to allude to
aplastar	to flatten, crush, smash
aplaudir	to clap, applaud
apoderar	to take power
arder	to burn, glow
arrebatar	to snatch, grab
arriesgar	to risk, venture
asentar	to settle, establish, locate
asesinar	to murder, assassinate
asignar	to assign, allocate
bañar	to bathe, take a bath
barrer	sweep, clean out
batir	to beat an object
bautizar	to baptize, christen
beneficiar	to benefit
burlar	to mock
calmar	to calm, soothe, relieve
cazar	to hunt
cenar	to dine
clavar	to nail
cocinar	to cook
compensar	to compensate, make up for
conectar	to connect, plug in
culminar	to culminate, accomplish
debatir	to debate, discuss
demorar	to delay, take time
desatar	to untie, unleash, spark off
descargar	to unleash, unload
descuidar	to neglect
desembocar	to flow, lead into
desplegar	to unfold, deploy
despreciar	to despise, scorn
disimular	to disguise, hide, pretend
disolver	to dissolve
disputar	to dispute, contest
eludir	to evade, avoid, elude
emerger	to emerge, surface
enamorar	to fall in love
encajar	to insert, fit well
ensayar	to test, rehearse
evolucionar	to evolve, develop
excluir	to exclude, reject
fallecer	to pass away 
finalizar	to end, finalize
fluir	to flow
herir	to wound, hurt
improvisar	to improvise
insinuar	to insinuate, hint
localizar	to locate, find, localize
motivar	to motivate, cause
nadar	to swim
navegar	to navigate, sail
ocasionar	to occasion, bring about
odiar	to hate
oler	to smell
perfeccionar	to perfect
perjudicar	to endanger
persistir	to persist
preceder	to precede
precipitar	to plunge, hurl, rush
preservar	to preserve
presidir	to preside over
presumir	to boast, show off, suppose
prevenir	to avoid, prevent [also evitar]
programar	to plan, program
reemplazar	to replace
reforzar	to reinforce, strengthen
regir	to rule, govern, manage
remitir	to remit
reponer	to replace, restore
resumir	to summarize
retomar	to retake, restart
rodar	to roll, run, scatter
rogar	to implore, pray, ask
rozar	to touch lightly
soplar	to blow 
subrayar	to underline, highlight, emphasize
suscitar	to arouse, provoke
temblar	to tremble, shake
tornar	to transform, turn
velar	to watch over
volcar	to turn/knock over, empty
votar	to vote
abstracto	abstract
agrícola	agricultural, farming
ambiguo	ambiguous
anual	annual, yearly
apasionado	passionate
apretado	tight, jammed
apto	appropriate, fit, able
asombroso	amazing
áspero	rough, coarse, harsh
asustado	scared, frightened
autoritario	authoritarian
autorizado	authorized
biológico	biological
brutal	brutal, savage
civilizado	civilized
comparable	comparable
complementario	additional, complementary
consagrado	dedicated, consecrated
costoso	costly, expensive
denso	heavy, dense, thick
desaparecido	missing
desigual	uneven, unequal
despierto	awake
diplomático	diplomatic 
disperso	spread out
dominante	dominant
educativo	educational
eficiente	efficient
egoísta	selfish
embarazada	pregnant
encantador	charming
espeso	thick, dense, stiff
estático	static, motionless
estudioso	studious
exigente	demanding, urgent
exótico	exotic
fabuloso	fabulous, fantastic
fascinante	fascinating
feroz	ferocious, fierce
flaco	thin, frail
franco	open, frank, outspoken
funcional	functional
furioso	furious
glorioso	glorious
horizontal	horizontal
hostil	hostile, unfriendly
imaginario	imaginary
impreso	printed
incierto	uncertain
inédito	unpublished
ingenuo	naive, ingenuous
insignificante	insignificant
insólito	unusual, uncommon
integrante	integral, part of a group
inverso	inverse, opposite
invisible	invisible
latinoamericano	Latin American
leal	loyal, faithful
lingüístico	linguistic
liso	smooth, flat, straight
lujoso	luxurious
manual	manual, handbook 
marginal	marginal, minor
masivo	mass, massive
matemático	mathematical
mensual	monthly
orgánico	organic
parcial	partial, biased
pardo	brown, dark, dim
penoso	painful, laborious
pésimo	dreadful, awful
poblado	populated
privilegiado	privileged
progresivo	progressive
propicio	appropriate, suitable
rebelde	rebel 
repleto	full, overcrowded
representativo	representative 
respetuoso	respectful
saludable	healthy, wholesome [also sano]
sangriento	bloody
solar	solar
sospechoso	suspicious
subterráneo	underground
sumo	utmost, highest
tecnológico	technological
temeroso	fearful
tendido	spread, hung, laid out
tibio	lukewarm
torpe	clumsy, awkward, slow
tropical	tropical
vasco	Basque
vigente	in force, valid
virgen	virgin 
adónde	to where?
antaño	in days gone by, last year
antemano	beforehand, in advance
asimismo	as well, also, moreover
diariamente	daily 
enormemente	enormously
enteramente	completely, entirely
extraordinariamente	extraordinarily
fuertemente	strongly
inclusive	including, even
inevitablemente	inevitably
intensamente	intensely
lamentablemente	regrettably
obviamente	obviously
simultáneamente	simultaneously
sinceramente	sincerely
suavemente	softly
cuidadosamente	carefully
compatriota	fellow countryman
rival	rival
acusación	accusation, charge
adquisición	acquisition
aguja	needle, spire, stylus
alianza	alliance
alusión	allusion, hint
amplitud	breadth, extent, range
antigüedad	antiquity, seniority
aprobación	approval, consent
asamblea	assembly
beca	scholarship, grant
bestia	beast, brute
bicicleta	bicycle
cabecera	head, header
capilla	chapel
caridad	charity
casita	cottage
ceniza	ash
censura	censorship, criticism
chispa	spark
clínica	clinic
comunión	communion
condena	sentence in prison, penalty
conservación	conservation
corrección	correction, amendment
cortina	curtain, screen
crueldad	cruelty, harshness
cuadra	city block, stable
cubierta	covering, top, lid
cumbre	summit, top
cuna	cradle, birth, lineage
cúpula	cupola, dome
dedicación	dedication, devotion
devoción	devotion
dieta	diet
difusión	spread, diffusion
disputa	dispute, argument, quarrel
dueña	landlady, owner 
dureza	hardness, toughness
elaboración	production [also producción]
electricidad	electricity
especulación	speculation, conjecture
espina	thorn, spine
ética	ethics
etiqueta	label, etiquette
exactitud	accuracy
excursión	excursion
excusa	excuse
expansión	expansion, spreading
expedición	expedition
explotación	exploitation, cultivation
fachada	front of a building
ficha	index card, chip, token
fidelidad	faithfulness, accuracy
franja	strip, stripe, fringe
generosidad	generosity
gira	tour
goma	rubber
hacienda	ranch
harina	flour
hazaña	deed, heroic feat
incapacidad	inability, incompetence
inocencia	innocence
inscripción	inscription, registration
insistencia	insistence, persistence
interrupción	interruption
intuición	intuition
invención	invention, contrivance
ira	rage, wrath
ironía	irony
lámina	sheet of metal
lealtad	loyalty, faithfulness
lentitud	slowness
llama	flame, llama
localidad	town, locality
maquinaria	machinery
mariposa	butterfly, wing nut
mecánica	mechanics, mechanism
medalla	medal, medallion
monja	nun
muralla	city wall
naturalidad	ease, spontaneity
oveja	sheep, ewe
paloma	dove
parada	transportation stop
pertenencia	membership, property
peseta	peseta 
peste	plague, pestilence, pest
pila	battery, pile, sink
pistola	gun, pistol
plataforma	platform, springboard
polémica	polemics, argument
proposición	proposition
prudencia	prudence, moderation
rebeldía	rebelliousness, defiance
redacción	editing, wording, essay
renuncia	resignation, renunciation
réplica	answer, retort, copy
represión	repression
reproducción	reproduction
retirada	retreat, withdrawal
revelación	revelation
revisión	checking revision
rienda	rein, restraint
ronda	round 
sábana	bed sheet
salvación	salvation, rescue
semejanza	similarity, likeness
seña	sign, mark, seal
serenidad	serenity, calm
solicitud	request, application
sugerencia	suggestion
supervivencia	survival
ternura	tenderness
tolerancia	tolerance
tortura	torture
trama	plot, theme
ubicación	position, location
uva	grape
vanidad	vanity, conceit
variante	variant, difference
vegetación	vegetation
vena	vein
villa	village, villa
víspera	eve
vitalidad	vitality, health
ansia	anxiety, anguish
aula	classroom
abismo	abyss, large gap
abrazo	hug, embrace
absurdo	absurdity, nonsense
ácido	acid
acorde	agreement, accord
adversario	adversary
algodón	cotton
alquiler	rent, rental
ancho	width 
aniversario	anniversary
antepasado	ancestor
aporte	contribution 
apunte	note, annotation
asalto	assault, robbery
ascensor	elevator
asombro	amazement, astonishment
bote	small boat
bulto	bulk, shape
buque	large ship
calendario	calendar
campamento	camp, camping
carbón	coal, charcoal
chocolate	chocolate
cinturón	belt
circo	circus
circuito	circuit, circumference, track
cobre	copper
colectivo	collective, group 
colmo; para colmo 		climax; to top it all
comandante	commander, commanding officer
coronel	colonel
correo	mail, post office
decreto	decree, order
descenso	decline, descent, lowering
desfile	parade, line, formation
desierto	deserted, desolate 
desplazamiento	movement, removal
diagnóstico	diagnosis
dicho	aforementioned, said 
diputado	deputy, member
discípulo	disciple
disgusto	disgust, annoyance
disparo	shot, discharge
divorcio	divorce
duelo	grief, affliction
encargo	job, order, errand
enfoque	focus, approach
escritorio	desk, bureau
espectro	ghost, specter
esplendor	splendor
estadio	stadium
evento	event
expediente	dossier, proceedings
fallo	mistake, blunder, fault
flujo	flow, tide, discharge
freno	brake
fundador	founder
gallo	rooster
gobernador	governor
heredero	heir, heiress
himno	hymn, anthem
insulto	insult
interlocutor	participant in a dialog
lecho	bed
lema	motto, slogan
lobo	wolf
mantenimiento	maintenance, sustenance
manto	cloak
mate	mate 
molde	mold, cast, pattern
oeste	West
pañuelo	handkerchief, shawl
parentesco	kinship
parto	birth
pasto	grass, pasture
perjuicio	damage, loss
planteamiento	proposal, exposition
polo	pole, polo, polo shirt
preso	imprisoned, confined 
préstamo	loan, borrowing
provecho	benefit, use
pulso	pulse, pulsation
puño	fist, handle, cuff
ratón	mouse, rat
realismo	realism
recorte	clipping, cutting, trimming
reglamento	regulations, rules
relieve; poner de relieve 		relief ; to emphasize
rendimiento	yield, output, efficiency
reposo	rest, peace
residuo	residue, waste
retraso	delay
ridículo	ridicule 
sillón	armchair, seat
sindicato	trade union
sobrino	nephew
temblor	tremor, shudder, shiver
teniente	lieutenant, deputy mayor
tercio	third 
titular	headline, holder 
trigo	wheat
umbral	threshold, outset
administrador	administrator, manager
embajador	ambassador
físico	physicist 
pescador	fisherman
coma	comma , coma 
abusar	to abuse
acarrear	to carry, result in, entail
acontecer	to happen, come about
agradar	to please
aguardar	to wait for, await
albergar	to lodge, harbor
alegar	to plead, argue
almorzar	to have lunch
alquilar	to rent, hire [also arrendar]
alumbrar	to light, illuminate
amanecer	to dawn, get light 
apelar	to call upon, appeal to
apostar	to wager, bet
arrepentir	to repent, regret
asaltar	to assault
asombrar	to amaze, astound
atrapar	to trap, catch
charlar	to chat, talk
complacer	to please, satisfy
complementar	to complement, supplement
conmover	to move, affect
consentir	to consent to, pamper
consolar	to console
consumar	to complete, carry out, consummate
contrastar	to contrast
coser	to sew
cuestionar	to question
dañar	to damage
derribar	to knock down, to demolish
derrumbar	to knock down, demolish
desbordar	to overflow, spill over
descomponer	to decompose, break down
desechar	to throw out
desencadenar	to unleash, unchain
desenvolver	to unwrap
deslizar	to slide, glide, slip
destrozar	to rip/break into pieces
disipar	to dispel, dissipate
dotar	to endow, bestow
embarcar	to embark, load
encarar	to front, confront
encarnar	to embody
enfocar	to focus
enfriar	to cool
entusiasmar	to fill with enthusiasm, excite
equivaler	to be equivalent, tantamount to
estirar	to stretch, strain
estrechar	to tighten, make closer
estrenar	to use for the first time, debut
explorar	to explore
extinguir	to extinguish, put out
filtrar	to seep, filter
florecer	to flower, bloom, flourish
fomentar	to foster, promote, encourage
fundir	to melt, cast, smelt
honrar	to honor
incitar	to incite
incrementar	to increase [also aumentar]
inscribir	to register, record [also registrar]
intercambiar	to exchange
interrogar	to question, interrogate
madurar	to mature, ripen
mojar	to make wet, dampen
morder	to bite
movilizar	to mobilize
mudar	to move, change
narrar	to narrate, tell
ofender	to offend
oscilar	oscillate
paralizar	to paralyze
parir	to give birth
pecar	to sin
predicar	to preach
prescindir	to do without
presenciar	to be present at, witness
profundizar	to deepen, analyze in depth
propiciar	to favor, foster, aid
radicar	to lie, be situated
ratificar	to ratify
reanudar	to renew, resume
recobrar	to recover, regain
recortar	to trim, cut off, clip
refugiar	to take shelter, give refuge
remover	to remove, stir
reprimir	to repress
reprochar	to reproach
resaltar	to emphasize
retornar	to return, give back [also devolver]
revivir	to revive
revolver	to stir, to make upset, to rummage through
sobrepasar	excel, out perform
sobresalir	to stand out, excel
subsistir	to subsist, survive
traicionar	to betray
traspasar	to go beyond, cross over
vaciar	to empty, pour out
verificar	to verify
acertado	correct, accurate
ágil	agile
agitado	agitated, irritated
agrario	agrarian, agricultural
alternativo	alternating, alternative
ambulante	traveling
amenazado	threatened
amistoso	friendly
apagado	turned off
arbitrario	arbitrary, high-handed
ardiente	passionate, ardent
atrapado	trapped
atrasado	behind, slow
audaz	audacious, bold
brasileño	Brazilian
cariñoso	affectionate
celeste	heavenly, sky-blue
celoso	jealous
clandestino	undercover, clandestine
coherente	coherent, connected
comprensible	understandable
comunitario	of the community
condicionado	conditioned
constitucional	constitutional
convincente	convincing 
criminal	criminal 
cuidadoso	careful, cautious
defensivo	defensive
descalzo	barefoot
deseable	desirable
desordenado	messy, confused
destruido	destroyed
detallado	detailed, thorough
dichoso	fortunate, happy
diminuto	diminutive, tiny, minute
dinámico	dynamic
disfrazado	disguised
efímero	ephemeral, short-lived
enterado	aware of
enterrado	buried
entusiasmado	enthused, excited
equivalente	equivalent 
espacial	spatial, space
estatal	state, government-owned
estéril	sterile, barren
estratégico	strategic
ético	ethical
expresivo	expressive
expreso	express, explicit
gigante	gigantic 
gráfico	graphic, explicit
grandioso	magnificent, grandiose
grosero	crude, rude, crass
holandés	Dutch
honrado	honest, respectable
hundido	buried, sunken
imprevisto	unforeseen, unexpected
incipiente	incipient, beginning
incomprensible	incomprehensible
indefinido	vague, indefinite
indiscutible	indisputable, unquestionable
indudable	unquestionable
inexplicable	unexplainable
infeliz	unhappy, unfortunate
inmerso	engrossed, immersed
inminente	imminent
inmóvil	immovable, motionless
inolvidable	unforgettable
inquietante	disquieting
invertido	reversed, inverted
irracional	irrational
justificado	justifiable, justified
latente	latent
lateral	side, lateral
liviano	light, frivolous
llamativo	striking
maldito	damned, wretched
matrimonial	matrimonial
mediocre	mediocre
minucioso	meticulous, thorough
mojado	wet
monótono	monotonous
necesitado	poor, needy
opaco	dull, opaque, heavy
óptimo	optimum
orientado	positioned, guided
paralizado	paralyzed
pasivo	passive
penal	penal
periodístico	journalistic
perpetuo	continual, perpetual
perteneciente	pertaining, belonging
peruano	Peruvian
perverso	perverse, wicked
pintoresco	picturesque
potencial	potential
precario	precarious
presidencial	presidential
primordial	fundamental, primary
proveniente,  procedente	coming from
publicitario	advertising
refinado	refined
reflejado	reflected
relevante	relevant, significant
republicano	republican
respetable	respectable
revuelto	confused, messed up
rosado	pink, rosy
ruidoso	noisy
rústico	rustic, rural
sanitario	health, sanitary, clean
semanal	weekly
sereno	serene, calm
silvestre	wild
solidario	united, jointly shared
sombrío	shady, dark, dismal
soviético	Soviet
súbito, repentino	sudden
suizo	Swiss
susceptible	susceptible
tenue	tenuous, flimsy
transitorio	transitory
veloz	fast, quick
adonde	to where
altamente	highly
ampliamente	widely
bruscamente	quickly, sharply
decididamente	decidedly, decisively
específicamente	specifically
extremadamente	extremely
independientemente	independently
íntimamente	intimately
mutuamente	mutually, each other
supuestamente	supposedly, allegedly
agradecido	grateful, thankful
retirado	retired, remote, secluded
cómplice	accomplice
delincuente	delinquent
gobernante	ruler, leader
interrogante	question, interrogator
noble	nobleman, noble 
rebelde	rebel, insurgent 
afueras	outskirts, suburbs
agitación	agitation, excitement
alerta	alert
amargura	bitterness, sorrow
apreciación	appreciation, assessment
aproximación	approximation
apuesta	wager, bet
bandeja	tray
barbaridad	atrocity
biografía	biography
bruja	witch, hag
burla	mockery, joke, trick
cadera	hip
calificación	evaluation, qualification
cancha	playing field, court
carcajada	hearty laughter, guffaw
cátedra	academic chair
ceja	eyebrow, brow
chimenea	chimney, fireplace
cima	summit, peak, top
colina	hill, slope
compensación	compensation
consigna	watchword, motto, slogan
constitución	constitution
contienda	contest, dispute
contribución	contribution 
cordillera	mountain range
cortesía	courtesy
corteza	bark, crust, rind, peel
cría	breeding, raising
densidad	density, thickness
dinámica	dynamics
elegancia	elegance, style
embajada	embassy
encuesta	poll, survey, inquiry
escultura	sculpture, carving
estatura	stature, height
estupidez, tontería	stupidity, stupid thing
eternidad	eternity
exageración	exaggeration
exploración	exploration
exportación	export, exportation
faena	task, job, performance
falla	flaw, failure
farmacia	pharmacy, drugstore
fatiga	fatigue
finca	property, estate
firmeza	firmness
fracción	fraction
fundación	foundation
furia	fury, rage
gala	gala 
ganancia	gain, profit
grabación	recording
ida	departure, first half of a trip
ilustración	illustration
imposibilidad	impossibility
imposición	imposition
imprenta	printing house
incorporación	inclusion, incorporation
indignación	indignation
integridad	integrity
jaula	cage, crate, playpen
leña	firewood
llanura	plain, prairie, plainness
longitud	length, longitude
maleta	suitcase, case
manta	blanket
marea	wave, tide, ebb
merced	favor, mercy
mierda	shit, crap, excrement
minoría	minority
narración	narration, account
niebla	fog
niñez	childhood, infancy
normalidad	normality
parcela	piece of property
parroquia	parish
pastilla	pill, capsule
patada	kick, punt
percepción	perception
perla	pearl
piedad	pity, mercy
plancha	electric iron, plate, sheet
presidencia	presidency
princesa	princess
procesión	procession
prohibición	prohibition
psicología	psychology
rebelión	rebellion
reconstrucción	reconstruction
resonancia	resonance, repercussion
sanción	sanction, approval, penalty
sede	headquarters, seat
sencillez	simplicity
sequía	drought
serpiente	snake
sinceridad	sincerity
superioridad	superiority
talla	size , stature
terraza	terrace, balcony
tertulia	get-together, meeting of friends
tira	strip, strap
tonelada	ton
transmisión	broadcast, transmission
transparencia	transparency, slide
validez	validity
vanguardia	vanguard, forefront
vejez	old age
verdura	vegetables, greenery
virgen	virgin 
abanico	range, handheld fan
aburrimiento	boredom
acercamiento	approach, approximation
acierto	good aim, guess, hit
adelanto, avance	advance, progress
aislamiento	isolation
ajuste	adjustment, settlement
alambre	wire
aliado	ally
alivio	relief, unburdening
altar	altar
amparo	protection, shelter
anhelo	longing, yearning
arranque	start, outburst, kick-start
arroyo	brook, stream, gutter
asco	disgust
atardecer	evening, dusk
atributo	attribute, quality
bastón	walking cane
bigote	mustache
a bordo 		on board
caudal	volume, abundance, fortune
chorro	stream, jet, spurt
clavo	nail, tack, peg
codo	elbow
colchón	mattress
collar	collar, necklace
comisario	commissioner, delegate
compás	rhythm, time, compass
comprador	buyer
conejo	rabbit
conocedor	expert, judge, connoisseur
consuelo	comfort, consolation
contorno	outline, perimeter, edge
convento	convent, monastery
corral	corral, yard
cuerno	horn, antler
desacuerdo	disagreement
deterioro	deterioration, damage
disparate	nonsense, blunder
egoísmo	selfishness
elogio	praise, eulogy, compliment
embarazo	pregnancy
emisor	transmitter, emitter
enlace	link, connection, bond
entierro	burial
entrenamiento	training
esqueleto	skeleton, framework
estallido	crash, outbreak, explosion
frasco	bottle, jar, flask
grueso	bulk, mass 
herido	wounded  
hígado	liver
intervalo	interval, gap
jovencito	young person
laberinto	maze, labyrinth
lapso	lapse
lío	mess, problem, bad situation
llanto	crying, weeping
mango	handle, mango
mármol	marble
mozo	waiter, youth, bellboy
ocio	leisure time
pilar	pillar, column
pino	pine tree
pleito	litigation, suit, dispute
productor	producer
protector	protector, defender
ramo	bunch of flowers, branch
reclamo	claim, complaint, protest
rencor	grudge, spite
repertorio	repertoire, list, index
resentimiento	resentment
riñón	kidney
rollo	roll, coil
rosario	rosary, beads, string
seguidor	follower, supporter, fan
seminario	seminar, seminary
sendero	foot path
sudor	sweat, perspiration
tablero	board, panel
tacto	sense of touch, feel
talón	heel, check, coupon, stub
tambor	drum
terremoto	earthquake
tinte	tint, dye
trago	drink, [a] swallow
traidor	traitor
trance	trance, fix, enrapture
trapo	rag, cloth
trastorno	confusion, trouble, upheaval
triángulo	triangle
truco	trick, ruse
veneno	poison, venom
volante	steering wheel
asesor	adviser, consultant
cocinero	cook
consejero	advisor, counselor
piloto	pilot, driver
portero	porter, doorkeeper, goalkeeper
senador	senator
servidor	servant
trabajador	hardworking 
lente	lens, [pl] glasses
aburrir	to bore, tire
acariciar	to stroke, fondle, caress
adornar	to adorn, to decorate
aferrar	to grasp, clutch
agravar	to aggravate, worsen
agrupar	to put in a group
aparentar	to give the appearance
apurarse, apresurarse		to hurry
argumentar	to argue, deduce
arrasar	to raze, ravage
articular	to articulate
atener	to abide by, comply with
calzar	to wear shoes
capturar	to capture
ceñir	to adhere to, fit tightly, encircle
chupar	to suck
circular	circular 
colar	to slip in [se]
concurrir	to coincide, concur, meet
condicionar	to condition, determine
configurar	to form, configure 
consagrar	to consecrate, establish
consolidar	to consolidate
constatar	to prove, verify
contagiar	to infect, infest
contradecir	to contradict, be inconsistent
coronar	to crown, top
debilitar	to weaken, debilitate
derramar	to shed, pour out
desafiar	to defy, stand up to
desfilar	to march, parade
despojar	to deprive, rob
devorar	to devour, consume
diluir	to dilute, weaken
disculpar	to excuse
dispersar	to disperse, scatter, spread
editar	to edit, publish, release
emocionar	to move, make/get excited
encabezar	to head, lead off
encaminar	to head for, guide
engendrar	to engender, beget
enlazar	to link, connect
entrevistar	to interview
espantar	to scare, frighten
evaluar	to evaluate, assess
evocar	to evoke, recall
expandir	to expand
fiar	to vouch for, confide, trust
fingir	to feign, pretend
fortalecer	to fortify
frecuentar	to frequent, visit
hervir	to boil
igualar	to equate, equalize
inquietar	to make uneasy, disturb
insultar	to insult, berate
interponer	to interpose, intervene
intuir	to sense
inundar	to flood, inundate
invocar	to invoke
latir	to beat 
liquidar	to liquidate, sell off
manipular	to manipulate, handle
obrar	to work, act
oscurecer	to get dark
ostentar	to flaunt, show off
palpar	to feel, touch, fondle
perdurar	to last, live on, endure
poblar	to populate, inhabit
predecir	to predict
prevalecer	to prevail
prosperar	to prosper, thrive
reaparecer	to reappear
rebajar	to lower, reduce, discount
regar	to water, irrigate
regular	to regulate, adjust 
reinar	to reign, prevail
rematar	to finish off, finish up
remediar	to heal, cure
repasar	to review, revise
replicar	to reply
restaurar	to restore, reinstate
retrasar	to delay, fall behind
reventar	to burst, puncture
sumergir	to submerge, plunge
sustentar	to maintain, support
titular	to title, call 
topar	to run into, bump into
torcer	to twist, bend, distort
trepar	to climb
vacilar	to vacillate, hesitate
vibrar	to vibrate, tremble
vincular	to connect, link, bind
anterior	previous, preceding
antiguo	old, ancient, former
bajo	under, underneath 
cada	each, every
capaz	capable, able
cierto	certain, sure, true
contrario	contrary, opposite
en cuanto a cuanto 		in terms of, regarding
cuyo	whose
demás	the rest, others
demasiado	too much, too many
derecho	right, justice, law 
distinto	distinct, different
enorme	enormous, vast
ese, esa 		that
este, esta 		this
al final final 		finally, in the end	
malo	bad
mayor	larger, older, main
medio	means, middle 
mejor	best, better 
menor	younger, youngest
menos	less, fewer
pasado	past, last 
pobre	poor
profundo	deep, profound
propio	own, proper, typical
real	royal, real, authentic
siguiente	following, next
solo	lonely, alone 
tal	such a
tanto	so much, so many
tercero	third
último	last, final
varios	several, various
verdadero	true, real
vivo	alive, bright
bastante	rather, fairly, quite a bit
alguno	some, someone
cualquier	any, anyone
ninguno	no, none, nobody
además	also, as well, besides
ahí, allí		there
allá	there, over there
antes	before
así	like that
atrás	behind
aún, todavía	still, yet
casi	almost, nearly
cerca	close, near
claro	of course, clearly 
cuando	when 
dentro  [also adentro]		inside		
después	after
durante	during, for 
encima	above, on top, in addition
entonces	so, then
fuera	out, outside, away
lejos	far away, far off
luego	later, afterwards
mal	badly 
muy	very, really
nunca	never, ever
pronto	soon, quick
quizás	perhaps, maybe
realmente	really, actually, in fact
si	if, whether
también	also
tampoco	neither, nor, either
tan	such, as, too, so
tarde	afternoon, evening 
todavía	still, yet [also aún]
a través 		across, over, through		
ya	already, still
él	he, [ellos] them 
lo	the 
aunque	although, even though
más	more
mientras	while, whereas, as long as
ni	not even, neither, nor
pero	but, yet, except
pues	then, well then
sino	but, except, rather
base	base, basis
cabeza	head 
cantidad	quantity, amount
cara	face, expression
carrera	career, course, race
clase	kind, class, order
condición	condition
cosa	thing
cuenta	bill, account
cuestión	question, matter
diferencia	difference
duda	doubt
edad	age
época	time, age, period
especie	kind, sort, species
experiencia	experience
falta	lack, shortage [also carencia]
familia	family
figura	figure
forma	form, shape, way
fuerza	strength, force, power
gente	people
gracia	thank you, grace, favor
guerra	war, warfare
historia	history, story
hora	hour, time 
idea	idea
imagen	image, picture
importancia	importance
ley	law, bill, rule
libertad	freedom, liberty
línea	line, course
luz	light
manera	way, manner 
mano	hand
medida ; a medida que		measure: to the extent		
mesa	table, board
muerte	death
necesidad	necessity, need
obra	work, book, deed
ocasión	opportunity, occasion
palabra	word
parte	part, portion
razón	reason
realidad	reality, actuality
relación	relationship, relation
respuesta	answer, reply
tierra	earth, land, ground
verdad	truth
vez	time 
vida	life
vista	view, sight
voz	voice
zona	area, zone 
acuerdo ; de acuerdo		accord: in agreement		
aire	air, wind, appearance
aspecto	aspect, appearance
cabo	end, bit
cambio	change
camino	road, route, path
campo	field, country
caso	case, occasion
centro	center, middle, downtown
conocimiento	knowledge
cuerpo	body
deber	should, to owe 
	day
dios	god, divinity
don	courtesy title , Mr., gift
efecto	effect
ejemplo	example
sin embargo, embargo 		nevertheless
esfuerzo	effort, endeavor
espacio	space, room
estado	state, condition, status
favor	favor, benefit
fondo	background, back, bottom
hecho	fact, happening
hombre	man, mankind, husband
interés	interest
juego	game, play, sport
lado	side
ladrón	thief
lugar	place, position
medio	half, middle 
mes	month
miedo, temor	fear
modo	way, manner 
momento	moment, time
movimiento	movement
objeto	object, thing
ojo	eye
papel	paper, role, part
parecer	to seem, look like 
partido	party, group, sports match
paso	step, pace
pesar	sorrow 
peso	peso , weight, load
pie	foot, base
poder	to be able to, can 
principio	beginning, principle
proceso	process, procedure
programa	program, plan
pueblo	people, village
punto	point, dot, period
respecto, con respecto a		respect, with regards to
resto	rest, remainder, leftover
saber	to know , find out 
santo	saint 
sentido	sense, feeling
servicio	service, helpfulness
siglo	century, age
sistema	system
suelo	ground, floor
tema	theme, subject, topic
tiempo	time , weather
trabajo	work, job, effort
valor	value, worth 
viaje	travel, trip
al frente: frente a frente 		facing; across from		
orden	order; sequence , religious 
ante	before, in the presence of
contra	against, opposite
desde	from, since
entre	between, among
hacia	toward, towards
hasta	until, up to, even 
según	according to
sobre	on top of, over, about
alguien	somebody, someone, anyone
cual	which, who, whom
cuál	which?
ello	it 
eso	that 
éste, ésta 		this one		
nada	nothing, not at all
nadie	nobody, anybody
qué	what?, which?, how !
quien	who, whom
quién	who?, whom?
acabar	to have just
aceptar	to accept
acercar	to come near
alcanzar	to reach, catch up with
aparecer	to appear
caer	to fall
cerrar	to close
comenzar, empezar	to start
comprender, entender	to understand
conseguir	to get, acheive
considerar	to consider
contar	to tell, count
convertir	to convert, change, become
crear	to create
creer	to believe, think
cumplir	to fulfill
decidir	to decide
decir	to tell, say
dejar	to let, leave
desarrollar	to develop
descubrir	to discover
detener	to stop, detain
dirigir	to direct, manage
echar	to throw
elegir	to choose, elect
empezar, comenzar	to begin, start
encontrar	to find
esperar	to wait, hope for, expect
evitar, prevenir	to avoid, prevent
existir	to exist
fijar	to set, fix, [se] notice
formar	to form
ganar	to win, earn
haber	to have 
hacer	to do, to make
importar	to matter, import
intentar	to try, attempt
levantar	to raise, lift
llegar	to arrive
llevar	to take, carry
lograr	to get, to manage to 
mantener	to keep, maintain
mostrar	to show
mover	to move, incite
nacer	to be born
observar	to observe, to notice
obtener	to obtain
ocupar	to occupy, use
ofrecer	to offer, present
oír	to hear
olvidar	to forget
partir	to leave, split
pasar	to pass, spend time
pedir	to ask for, request
perder	to lose, miss
poder	power 
poner	to put on
proponer	to propose
quedar	to remain, stay
realizar	to fulfill, carry out
recibir	to receive
reconocer	to recognize, admit
recordar, acordar		to remember, remind	
referir	to refer to, tell
sacar	to take out
salir, partir	to leave
seguir	to follow, to go on
señalar	to point out, signal
ser	being 
soler, acustombrar	to be accustomed to
subir	to go up
suceder	to happen
sufrir	to suffer, undergo
suponer	to suppose, assume
tocar	to touch, play an instrument
traer	to bring, carry
tratar	to try, treat, deal with
valer	to be worth, cost
volver	to turn, to return to a place
accesible	accessible
acelerado	accelerated, quick
acomodado	well-to-do, suitable
afín	related, similar
afortunado	fortunate
alarmante	alarming
andaluz	Andalusian
angustiado	anguished, distressed
angustioso	distressing
aplastado	crushed, flattened
árido	arid, dry
asombrado	amazed, bewildered
atroz	atrocious
bancario	bank, banking
bélico	warlike
bendito	blessed
bíblico	biblical
callejero	of the street
caprichoso	capricious, whimsical
carente	lacking, devoid
cerebral	cerebral
colorado	red, colored
combinado	combined
comprensivo	understanding 
confundido	confused
congelado	frozen
constructivo	constructive
contundente	decisive, blunt, forceful
cordial	cordial, friendly
corporal	of the body, corporal
crónico	chronic
decente	respectable, decent
desconcertado	disoriented, disconcerted
eclesiástico	ecclesiastical
elocuente	eloquent
entusiasta	enthusiastic
esporádico	sporadic
estadístico	statistical
exento	exempt, free
extra	extra
fértil	fertile, rich
frívolo	trivial, frivolous
frontal	frontal
geométrico	geometric
grotesco	grotesque, ridiculous
guerrero	warrior, warlike 
ilegal	illegal
ilimitado	unlimited
impecable	impeccable, faultless
implacable	relentless, implacable
imponente	impressive, magnificent
importado	imported
impreciso	imprecise
inestable	unstable, unsteady
inexistente	non-existent
ingenioso	ingenious, clever
inseguro	unsure, unsafe
inseparable	inseparable
institucional	institutional
íntegro	whole, entire, honest
involuntario	involuntary
irónico	ironic, mocking
irreal	unreal
irreversible	irreversible
laborioso	laborious, industrious
larguísimo	very long
llano	flat, level, plain
maligno	evil, malignant
melancólico	melancholy
minúsculo	minute, insignificant
mismísimo	very same
místico	mystical
monstruoso	monstrous
nítido	clear, clean, neat
nulo	void, null
ocasional	occasional, random
parlamentario	parliamentary
paterno	paternal
patriótico	patriotic
pedagógico	pedagogical, teaching
pequeñito	very small, tiny
persistente	persistent
piadoso	pious, devout, merciful
prematuro	premature
prestigioso	prestigious
presunto	alleged, presumed
previsible	foreseeable
prodigioso	prodigious, famous
provincial	provincial
recíproco	reciprocal
robusto	strong, robust, sturdy
rudo	rude, crude, coarse
sabroso	delicious, tasty
secular	secular, lay
séptimo	seventh
simultáneo	simultaneous
siniestro	sinister
sintético	synthetic
soberano	sovereign, self-assured
soberbio	proud, arrogant [also orgulloso]
sofisticado	sophisticated
sonriente	smiling
sumido	sunken, drowned
terrestre	earthly, of the earth
trascendental	momentous, transcendental
trascendente	transcendent
trasero	behind, back
vertiginoso	dizzying
vigoroso	vigorous, strong
abiertamente	openly
brevemente	briefly
debidamente	properly, duly
duramente	harshly, severely
espontáneamente	spontaneously
firmemente	firmly
largamente	for a long time, at length
parcialmente	partially
públicamente	publicly, in public
viceversa	vice versa
fiscal	district attorney, prosecutor 
gigante	giant 
idiota	idiot, dunce
abeja	bee
abstracción	abstraction
acera	sidewalk
adhesión	adherence
agonía	agony, grief
agresividad	aggressiveness
almohada	pillow
antena	antenna
araña	spider
audacia	boldness, audacity
autopista	freeway, motorway
bahía	bay
balanza	balance,  scale
batería	battery, gun deck
bodega	cellar, pantry, warehouse
caballería	cavalry, knighthood
cabina	cabin, cockpit
cabra	goat
cal	lime, whitewash
cautela	caution
cera	wax
clientela	customers, clients
complejidad	complexity
complicidad	involvement, complicity
concurrencia	coming together, participation
consistencia	consistency
conspiración	conspiracy
contestación	answer
convención	convention, assembly
cuenca	socket, basin, bowl
cueva	cave
decena	ten 
decepción	disappointment, disenchantment
decoración	decoration
delicadeza	gentleness, tenderness
denominación	name, denomination
descarga	unloading, discharge
desilusión	disappointment, letdown
despedida	goodbye, farewell
destreza	skill
detención	detention, arrest
dicha	fortune, happiness, luck
diligencia	diligence
disculpa	apology, excuse
distracción	distraction, amusement
diversidad	diversity, variety
edificación	construction, building
eficiencia	efficiency
elevación	rise, elevation, increase
emisión	broadcast, emission
entrañas	insides, bowels
envergadura	breadth, expanse
equivocación	mistake, misconception
espuma	foam, lather
estampa	print, engraving, illustration
estética	aesthetics
euforia	euphoria, elation
exhibición	exhibition, showing
expulsión	expulsion, ejection
fabricación	manufacture, production
facción	face feature, faction
factura	invoice, bill
fiera	wild beast
flecha	arrow, dart
frialdad	coldness, indifference
gama	range, musical scale
garra	claw, fang
gratitud	gratitude
grieta	crack, opening, slit
hectárea	hectare
higiene	hygiene
hormiga	ant
hostilidad	hostility, enmity
impotencia	impotence
incidencia	incidence, impact
incursión	invasion, incursion
inundación	flood, deluge
inyección	shot, injection
jugada	move, play
latitud	latitude
lesión	injury, wound, harm
libra	pound 
librería	bookstore
limosna	alms, charity
maldad	evil, wickedness
maldición	damnation, curse
manía	obsession, mania
matanza	slaughter, carnage
mejilla	cheek
metáfora	metaphor
modalidad	mode, manner
navaja	razor, blade, navaja
navegación	navigation, shipping
nobleza	nobility, uprightness
obediencia	obedience
ocurrencia	idea, witty remark
olla	pot, kettle
órbita	orbit, socket, field
pala	shovel
partícula	particle
penetración	penetration, insight
penumbra	semidarkness, twilight
pinta	pint, aspect, dot
piscina	swimming pool
pólvora	gunpowder, powder
prevención	prevention, warning
prioridad	priority
procedencia	origin, source
prolongación	extension
prosa	prose
pugna	battle, struggle
puta	whore, prostitute
recompensa	reward, recompense
reivindicación	claim, demand, redemption
repercusión	repercussion, impact
resignación	resignation, acceptance
restricción	restriction
rigidez	rigidity
senda	path, lane
servidumbre	staff of servants, servitude
significación	meaning, significance
sirena	siren, mermaid
soberanía	sovereignty
sobra	excess, surplus, leftover
tasa	rate, fee, levy
toalla	towel
torta	cake
tregua	truce, rest
vara	rod, stick
vecindad	nearness, vicinity
ventanilla	vehicle window, box office
vereda	path, sidewalk
acta	meeting proceedings, minutes
adjetivo	adjective
admirador	admirer
agradecimiento	gratitude, gratefulness
apuro	trouble, predicament
artefacto	artifact, device
asilo	asylum, shelter
astro	star 
atentado	attack, offense
bachillerato	high school diploma
banquete	banquet, feast
bicho	bug, creature
buey	ox
burro	donkey
caldo	broth, bouillon, soup
campeón	champion
caramelo	piece of candy, caramel
centavo	cent
cerco	fence, circle, ring
chiquillo	kid, youngster
coco	coconut
cohete	rocket
comando	command, order
complemento	complement, supplement
comunismo	communism
convencimiento	convincing 
cordón	cord, yarn, braid
cráneo	skull, cranium
delirio	delirium, nonsense
desconcierto	disorder, chaos
descuido	neglect, oversight
desenlace	outcome, result
desequilibrio	imbalance, unsteadiness
desperdicio	waste, refuse, garbage
despliegue	deployment, display
diamante	diamond
dictador	dictator
emperador	emperor
encaje	lace
enigma	enigma, mystery
ente	entity, being, firm
entretenimiento	entertainment
equivalente	equivalent 
escaparate	showcase, display window
escrito	manuscript, writing
fósforo	match, match stick
gabinete	cabinet, den, office
ganador	winner
gusano	worm, caterpillar
hueco	hollow 
incremento	increase, raise
infinito	infinite, infinity 
intermedio	means, interval 
jinete	rider, horseman
lomo	back, loin, spine
martillo	hammer
medicamento	medicine, drug
micrófono	microphone
molino	mill, windmill
mosaico	mosaic
muelle	wharf, dock
muslo	thigh
olfato	sense of smell
oso	bear
oxígeno	oxygen
pabellón	pavilion, sports hall
padrino	godparent, sponsor
paraje	place, spot
paréntesis	parenthesis, digression
pasajero	fleeting, transitory 
pato	duck
peón	unskilled laborer, field hand
periodismo	journalism
pionero	pioneer
precedente	precedent
profeta	prophet
puñado	fistful, small group
rancho	ranch, farm
rebaño	herd, flock
recelo	mistrust, suspicion
recipiente	container, recipient, tank
reproche	reproach, criticism
rescate	rescue, ransom
retiro	withdrawal, retreat
retroceso	movement backwards
roce	brush, rubbing, contact
rol	role
sargento	sergeant
soporte	support, endorsement
sótano	basement
tanque	tank, large container
tejado	roof, housetop
temperamento	temperament, personality
tenor	meaning, sense, tenor
tranvía	trolley, tram, streetcar
trazo	line, stroke
trono	throne
vaivén	swinging, rocking
vegetal	plant, vegetable 
velo	veil
vestuario	wardrobe, changing room
volcán	volcano
bailarín	dancer
cirujano	surgeon
diplomático	diplomat 
guerrero	warrior, soldier 
marinero	sailor
cólera	rage , cholera 
cometa	comet , kite 
editorial	publisher , editorial article 
acatar	to comply with, abide by
adentrar	to penetrate, go inside
adherir	to adhere, attach
aflojar	to loosen
alarmar	to alarm
alertar	to alert, warn
alojar	to host, accommodate
andar	walk, gait, pace 
asentir	to assent, agree
aventurar	to venture, risk
bordear	to border
conferir	to confer
decaer	to decay, wane
demandar	to claim, sue
descifrar	to decipher
desesperar	to despair, lose hope
desmentir	to contradict
despejar	to clear up
deteriorar	to deteriorate
dialogar	to confer, talk
discurrir	to flow, pass, roam
disfrazar	to disguise, hide, conceal
encomendar	to commend, entrust
endurecer	harden, make hard
enfermar	to become ill
engordar	to fatten, get fat
enredar	to entangle, ensnare
ensuciar	to get dirty
entablar	to start, establish
entrenar	to train
enumerar	to enumerate, count
envidiar	to envy
estropear	to ruin, mess up
exceder	to exceed, excel
excitar	to excite
fascinar	to fascinate
financiar	to finance
impartir	to impart, administer
incidir	to influence, affect
incurrir	to incur, fall into
indagar	to investigate [also investigar]
insertar	to insert, put in
instruir	to instruct
internar	to confine
irritar	to irritate
irrumpir	to burst in, raid
joder	to f**k, screw 
largar	to let go, start out
ligar	to tie, link, bind
mediar	to mediate
percatar	to inform, become aware
perfilar	to outline, shape
perturbar	to perturb, upset
posar	to rest, pose, land
predominar	to predominate
premiar	to award
presentir	to sense in advance
propagar	to propagate, spread
rascar	to scratch, scrape
razonar	to reason out, think
rebasar	to exceed, pass over
recrear	to recreate, amuse
rectificar	to rectify, straighten out
relajar	to relax
renacer	to be reborn, reappear
reposar	to rest, lie down
resignar	to resign, relinquish
restablecer	to reestablish, restore
resucitar	to resuscitate, revive 
sobrevenir	to happen unexpectedly, befall, ensue
sudar	to sweat
suspirar	to sigh
tentar	to tempt, entice
transitar	to roam, go by
tumbar	to knock over, cast down
vengar	to take revenge, avenge
verter	to pour, spill, shed
vislumbrar	to glimpse